Gll^Fp, Gll^Fp, Gll^Fp, Gs, Gs, Gll^Fp, Gs, Gs, Gll^Fp, Gll^Fp, Rb, Gs, Gs, Gs, Gll^Fp, Gs, Gs, Gs, Gs, Gs, Gs, Gs, Gs, Gs, Gs, Gs, Gs, Gs, Gs, Gs, Gs, Gs, Gs, Gs
Gll^Fp, Gs, Gll^Fp, Aa, Gs, Gll^Fp, Gs, Gs, Gs, Gll^Fp, Rb, Gs, Gs, Gs, Gs, Gs, Gs, Gs, Gs, Gs, Gll^Fp, Gll^Fp, Gll^Fp, Gs, Gs, Gs, Gs, Gs, Gs, Gs, Gll^Fp, Gs, Gs, Gs
Gll^Fp, Gll^Fp, Gs, Gs, Gs, Gs, Gll^Fp, Gs, Gll^Fp, Gll^Fp, Rb^Eff, Gs, Gs, Gs, Gll^Fp, Gs, Gs, Gll^Fp, Gs, Gs, Gs, Gs, Gs, Gs, Gs, Gs, Gs, Gll^Fp, Gll^Fp, Gll^Fp, Gs, Gll^Fp, Gs, Gs
Gll^Fp, Gs, Gll^Fp, Gs, Gs, Gs, Gs, Gs, Rb^Eff, Rb^Eff, Rb^Gvs, Rb^Eff, Rb^Eff, Gs, Gll^Fp, Gll^Fp, Gs, Gs, Aa, Gs, Gs, Gs, Gll^Fp, Gs, Aa, Gs, Gs, Gll^Fp, Gs, Gs, Gs, Gs, Gs, Gs
Gs, Gs, Gs, Gll^Fp, Gs, Gll^Fp, Rb^Eff, Rb^Eff, Rb^Gvs, Rb^Gvs, Rb^Gvs, Rb^Gvs, Rb^Gvs, Rb^Eff, Gs^Eff, Gs, Gs, Gll^Fp, Hh^Fp, Gll^Fp, Gs, Gll^Fp, Gs, Gs, Gs, Gll^Fp, Gs, Gs, Hh, Gs, Gs, Gs, Gs, Gs
Gs, Gs, Gs, Gll^Fp, Gs, Rb^Eff, Rb^Eff, Rb^Gvs, Rb^Gvs, Rb^Gvs, Rb^Gvs, Rb^Gvs, Gs^Vl, Aa, Gs, Gs^Eff, Gs^Eff, Gs, Gs, Gs, Aa, Gs, Gll^Fp, Gs, Gs, Gs, Gll^Fp, Gs, Gs, Gll^Fp, Gll^Fp, Gll^Fp, Gll^Fp, Gll^Fp
Wwg, Gs, Gs, Gs, Gll^Fp, Gs, Gs^Eff, Rb^Eff, Rb, Rb^Gvs, Re, Re, Re, Gs, Gs, Gs, Re, Gs^Eff, Gs^Eff, Gs, Gs, Aa, Aa, Gll^Fp, Gs, Gll^Fp, Hh, Gs, Gs, Gs, Gs, Gs, Gs, Gs
Wwg, Gs, Gs, Gll^Fp, Gs^Eff, Gs^Eff, Gs, Gs^Vh, Re, Re, Ket, Ce, Re, Gs^Vh, Re, Re, Gs, Gs^Vh, Gs^Eff, Gs^Eff, Gs, Gs, Gs, Gs, Gs, Hh, Hh, Gll^Fp, Gs, Gll^Fp, Gs, Gll^Fp, Gll^Fp, Gll^Fp
Wwg, Gs, Gs^Eff, Gs^Eff, Gs^Vh, Gs, Re, Re, Re, Ce, Ce, Ce, Re, Re, Aa, Gs, Gs^Eff, Gs^Eff, Gs, Gll^Fp, Gll^Fp, Gs, Gs, Gs, Gs, Gs, Gs, Aa, Gs, Hh, Hh, Hh, Hh, Hh
Gs, Wwg, Gs, Gs^Eff, Gs^Eff, Re, Gs, Gs, Gs^Vh, Re, Re, Gs^Vh, Re, Re, Gs^Vh, Gs, Gs, Gs^Eff, Gs^Eff, Gs, Gs, Gs, Gll^Fp, Gs, Gs, Gs, Gs, Gs, Gs, Gs, Gs, Gs, Gs, Gs
Gs, Wwg, Ww, Gs, Gs^Eff, Gs^Eff, Aa, Gs, Re, Re, Re, Re, Re, Re, Re, Gs, Gs, Gs^Eff, Gs, Gs, Gs, Gs, Gs, Gll^Fp, Gs, Gs, Gs, Gs, Aa, Gs, Hh^Fp, Gs, Gs, Gs
Gs, Aa, Ww, Gs^Eff, Gs^Eff, Gs, Re, Re, Gs, Gs, Gs^Vh, Re, Re, Re, Rr, Ce, Gs, Gs, Gs, Gs, Gs, Gs, Gll^Fp, Gll^Fp, Gs, Gs, Gs, Gs, Gs, Hh^Fp, Gs, Hh, Gs, Gs
Gs, Gs, Wwg, Gs, Re, Re, Gs^Eff, Gs, Gs, Gs, Gs, Gs, Gs^Eff, Ce, Rr, Gs, Gs, Aa, Gs, Gs, Gs, Gs, Gs, Gs, Gs, Gll^Fp, Gll^Fp, Gs, Gs, Gs, Gs, Hh, Gs, Gs
Gs, Gs, Ww^Bw/, Re, Gs, Gs, Gs, Gs^Eff, Gs^Eff, Aa, Gs^Eff, Gs^Eff, Aa, Gs, Gs, Rr, Rr, Gs, Gs, Gs, Gs, Gll^Fp, Gs, Aa, Gs, Gs, Gs, Gll^Fp, Gs, Gs, Gs, Gs, Gs, Gs
Re, Re, Ww, Gs, Gs, Gll^Fp, Gs, Gs, Gs, Gs, Gs, Gs, Gs, Gs, Gs, Gs, Gs, Rr, Rr, Gs, Gs, Gs, Gs, Gs, Gs, Gs, Gs, Gs, Gs, Gll^Fp, Gll^Fp, Gll^Fp, Gll^Fp, Gll^Fp
Gs, Gs, Gs, Ww, Gll^Fp, Gll^Fp, Gs, Gs, Gs, Gs, Gs, Gs, Gs, Gs, Gs, Gs, Gll^Fp, Gs, Aa, Rr, Rr, Gs, Gs, Gs, Gs, Aa, Gs, Gs, Gs, Aa, Aa, Aa, Aa, Aa
Gs, Gs, Gs, Ww, Gll^Fp, Gs, Gs, Gs, Gs, Aa, Gs, Gs, Gs^Efm, Gs, Gs, Gll^Fp, Gs, Gs, Gs, Gs, Gs, Rr, Rr, Gs, Gs, Gll^Fp, Gs, Gs, Gs, Gs, Gs, Gs, Gs, Gs
Gs, Gs, Aa, Ww, Ww, Gs, Aa, Gs, Gs, Gs, Gll^Fp, Gs, Gs, Gs, Gll^Fp, Gs, Wwg, Gs, Gs, Gs, Gs, Gs, Gs, Rr, Rr, Gs, Gs, Gs, Gs, Gs, Ce, Gs, Gs, Gs
Gs, Gs, Gs, Gs, Gs, Wwg, Wwg, Wwg, Wwg, Gs, Gll^Fp, Gll^Fp, Wwg, Hh, Wwg, Wwg, Hh, Wwg, Wwg, Aa, Gs, Gs^Efm, Gs, Gs, Gs, Rr, Rr, Gs, Gs^Vct, Ce, Ce, Gs, Gs, Gs
Gs, Aa, Gs, Gs, Gs, Gs^Vhr, Gs, Gll^Fp, Gs, Wwg, Wwg, Wwg, Gs, Wwg, Gs, Gll^Fp, Hh, Gs, Gs, Wwg, Wwg, Gs, Gll^Fp, Gll^Fp, Gll^Fp, Gs, Gs, Rr, Rr, Ke, Rr, Gs, Gs, Gs
Gs, Gs, Gs, Aa, Gs, Gs, Gs, Gs, Gll^Fp, Gs, Gs, Gs, Gs, Gs, Aa, Gs, Gs, Gs, Gs, Gs, Gs, Wwg, Wwg, Gll^Fp, Gs, Gs, Gs, Gs, Gs, Rr, Hh^Fp, Rr, Rr, Gs
Gs, Gs, Gs, Gs, Ww, Gs, Gs, Gll^Fp, Gll^Fp, Gs, Aa, Gs, Gs, Gs, Gs, Gs, Gs, Gs, Gs, Aa, Gs, Gs, Gs, Wwg, Gs, Gs, Gs, Gs, Rr, Gs, Gs, Hh, Gs, Rr
