Mm, Mm, Mm, Mm, Mm, Mm, Mm, Mm, Mm, Mm, Mm, Mm, Mm, Mm, Mm, Mm, Mm, Gs, Mm, Mm, Ms, Gs, Ms, Mm, Mm, Mm, Mm, Mm
Mm, Mm^Xm, Mm, Mm, Mm, Mm, Mm, Mm, Mm, Mm, Mm^Xm, Mm, Mm, Mm, Hh, Hh, Hh, Mm, Mm, Mm, Mm, Ms, Ms, Ms, Mm, Mm^Xm, Mm, Mm
Mm, Mm, Mm, Mm, Mm, Mm, Mm, Mm, Gs, Gs, Gs, Aa, Gs, Mm, Aa, Mm, Mm, Hh, Aa, Mm, Mm, Ms, Ms, Ms, Mm^Xm, Mm, Mm, Mm
Mm, Mm, Mm, Mm, Hh, Hhd^Vhhr, Hh, Aa, Gs, Gll^Fp, Gs, Gll^Fp, Gs, Gll^Fp, Gs, Gs, Aa, Mm, Ce, Mm, Mm, Mm, Hh, Mm, Mm, Mm, Mm, Mm
Mm, Mm, Mm, Hh, Aa, Gs, Gll^Fp, Hh, Gs, Gs, Gs, Gll^Fp, Gs, Gs, Re^Vct, Gs, Gs, Hh, Ce, Ket, Ce, Mm, Hh, Mm^Xm, Mm, Mm, Mm, Mm
Mm, Mm, Hh, Hh, Gs, Gs, Gs, Gs, Gs, Gll^Fp, Gs, Gs, Re^Vct, Re, Re^Ecf, Re, Re, Re^Vct, Re, Ce, Aa, Hh, Hh, Hh, Hh, Mm, Mm^Xm, Gs
Gs, Mm, Hh, Gs, Gll^Fp, Gll^Fp, Gs, Gll^Fp, Gs, Gs, Gll^Fp, Hh, Gs, Re, Re, Re, Re, Re, Gs, Gs, Gs, Gs, Gs, Hh, Gll^Fp, Aa, Gs, Ha
Gs, Hh, Hh, Gs, Gs, Gs, Gs, Gs, Gs, Hh, Aa, Hh, Ce, Gs, Re, Re, Re, Re, Re^Vct, Aa, Gs, Gll^Fp, Aa, Gs, Gll^Fp, Gll^Fp, Ha, Ha
Gs, Hh, Gs, Gll^Fp, Gll^Fp, Gs, Gll^Fp, Aa, Gs, Aa, Gs, Gs, Re, Re, Ce, Gs, Gs, Re, Re, Re, Re, Gs, Gll^Fp, Gs, Gs, Gs, Hh, Gs
Gs, Hh, Hh, Gs, Gs, Gs, Gs, Gs, Gs, Gs, Re, Re, Gs, Gs, Gs, Gs, Gs, Re, Re, Re^Ecf, Re, Gs, Gs, Gs, Hh, Hh, Mm, Mm
Gs, Hh, Gs, Gs, Gs, Aa, Gs, Gs, Re, Re, Gs, Gll^Fp, Gs, Gs, Aa, Gll^Fp, Gs, Re^Vct, Gs, Re, Aa, Re^Vct, Gs, Aa, Mm, Mm, Mm^Xm, Mm
Gs, Ce, Ce, Re^Vct, Gs, Gs, Re, Re, Gs, Aa, Gs, Gs, Gll^Fp, Gs, Gs, Hh, Gs, Gs, Hh, Gs, Gs, Gs, Gs, Hh, Mm, Mm, Mm, Mm
Gs, Ce, Ke, Ce, Re, Re, Gs, Gs, Gs, Gs, Gs, Gs, Aa, Gs, Gll^Fp, Gs, Aa, Hh, Mm, Mm, Mm, Aa, Ms, Ms, Ms, Mm, Mm^Xm, Mm
Gs, Gs, Gs, Re, Gs, Gs, Gs, Aa, Gs, Gll^Fp, Gs, Gs, Gs, Gs, Gs, Gs, Mm, Mm, Gs, Mm, Mm, Mm, Gs, Ms, Ms, Mm, Mm, Mm
