Gs, Gs, Aa^Fpa, Gs, Gs, Ww^Bw\r, Ww^Bw\r, Wwg, Aa, Gs, Gs, Gs, Gs, Gs, Rp, Gs, Gll^Fp, Gs, Gs, Gs, Gs, Gs, Ms, Gs, Gs
Ai, Aa, Gs, Gs, Gll^Fp, Ai, Ai, Rp, Rp, Gs, Re^Vct, Aa^Fpa, Ke, Aa, Rp, Gs, Gs, Gs, Aa, Gs, Aa, Ms, Ms, Ms, Gs
Ai, Ai, Ai, Aa, Aa^Fpa, Wwrg, Wwrg, Gd^Vhr, Aa, Rp, Rp, Ce, Ce, Ce, Rp, Hh, Gs, Gs, Aa, Aa, Gs, Gs, Gs, Aa^Vca, Gs
Ai, Ai, Wwg, Ai, Wwg, Wwrg, Wwrg, Gs, Gs, Gs, Gs, Rp, Rp, Gll^Fp, Rp, Aa, Aa, Gll^Fp, Hh, Gs, Aa, Hh, Aa, Gs, Gs
Ww, Wwg, Wwg, Wwg, Wwg, Wwg, Wwg, Chw, Khw, Gs, Gs, Gs, Gs, Rp, Aa^Vha, Aa, Aa, Gs, Gs, Gs, Gs, Gs, Aa^Fpa, Gs, Gs
Wwg, Wwg, Wwg, Wwrg, Wwg, Wwg, Wwg, Chw, Chw, Re^Vct, Aa, Gs, Aa, Rp, Gs, Aa, Gs, Gs, Gs, Aa, Aa, Aa^Fpa, Aa^Fpa, Aa, Gs
Wog, Wwg, Wwg, Wwg, Wwrg, Wwg, Wwg, Wwg, Ai, Chr, Gs, Aa, Aa, Rp, Rp, Gs, Gs, Gll^Fp, Gs, Gs, Gs, Aa^Fpa, Gs, Gs, Gs
Wog, Wog, Wog, Wwg, Wwg, Wwg, Wwg, Wwg, Wwg, Ai, Ai, Aa, Gs, Gs, Gs, Rp, Rp, Gs, Aa, Gs, Gs, Ha, Gs, Aa, Gs
Wog, Wog, Wog, Wog, Wog, Wwg, Wwg, Wwg, Wwg, Wwg, Wwg, Ai, Gs, Gs, Gll^Fp, Gs, Rp, Gd^Vhr, Gs, Gs, Gs, Ha, Gs, Gs, Gs
Wog, Wog, Wog, Wog, Ww^Vm, Wog, Wog, Wwg, Wwrg, Wwg, Wwg, Ai, Ai, Gs, Gs, Gs, Aa, Rp, Gs, Hh, Aa, Gs, Gs, Aa^Fpa, Gs
Wog, Wog, Wog, Wog, Cme, Cme, Cme, Wog, Wog, Wwg, Wwrg, Wwg, Wwg, Ai, Gs, Aa, Gs, Rp, Rp, Aa, Gs, Gs, Hh, Gs, Gs
Wog, Wog, Wog, Wwrg, Wog, Kme, Wog, Ww^Vm, Wog, Wog, Wwg, Wwg, Wwg, Ai, Ai, Aa, Gs, Aa, Gs, Rp, Gs, Aa, Aa, Hh, Gs
Wog, Wog, Wog, Wog, Wog, Wwrg, Wwrg, Wog, Wog, Wog, Wwg, Wwrg, Wwg, Wwg, Ai, Gs, Gll^Fp, Gs, Aa, Rp, Gs, Aa^Fpa, Gs, Aa, Gs
Wog, Wog, Wog, Wog, Wog, Wog, Wog, Wog, Wog, Wog, Wwg, Wwg, Wwg, Wwrg, Wwg, Ai, Ai, Gs, Aa, Rp, Rp, Gs, Gs, Gs, Gs
Wog, Wog, Wog, Wog, Wog, Wog, Wog, Wog, Wog, Wog, Wog, Wwrg, Wwg, Wwg, Wwg, Wwg, Ai, Gs, Aa, Aa, Gs, Rp, Ce, Re^Vct, Gs
Wog, Wog, Wog, Wog, Wog, Wog, Wog, Wog, Wog, Wog, Wog, Wwg, Wwg, Wwrg, Wwg, Wwg, Wwrg, Ai, Ai, Aa, Gs, Rp, Ce, Ce, Gs
Wog, Wog, Wog, Wog, Wog, Wog, Wog, Wog, Wog, Wog, Wog, Wog, Wog, Wwg, Wwg, Wwg, Wwg, Wwg, Wwg, Ai, Gs, Rp, Gs, Ke, Gs
Wwg, Wog, Wog, Wog, Wog, Wog, Wog, Wog, Wog, Wog, Wog, Wog, Wwg, Wog, Wog, Wwg, Wwg, Wwg, Wwg, Ai, Gs, Rp, Gs, Gs, Gs
