Gs, Gs, Gs, Gs, Aa^Fpa, Gs, Gs, Wwg, Wwg, Wwg, Aa, Gs, Gs, Gs, Gs, Gs, Rp, Gs, Hh, Gs, Gs, Gs, Gs, Gs, Aa^Fpa, Gs, Gs, Gs, Hh, Hh
Gs, Aa^Fpa, Gs, Aa^Fpa, Rr, Rr, Rr, Wwg, Wwg, Wwg, Aa, Gs, Gs, Aa^Fpa, Aa^Fpa, Gs, Rp, Gs, Gll^Fp, Gs, Gs, Aa^Fpa, Gs, Aa^Fpa, Aa, Gs, Gs, Aa, Ms, Hh
Gs, Gs, Rr, Rr, Aa^Fpa, Gs, Gs, Wwg^Bw\r, Wwg^Bw\r, Wwg, Aa, Gs, Gs, Gs, Gs, Gs, Rp, Gs, Gll^Fp, Gs, Gs, Hh, Gs, Gs, Ms, Gs, Gs, Ms, Hh, Gs
Rr, Rr, Ai, Aa, Gs, Gs, Gll^Fp, Ai, Ai, Rp, Rp, Gs, Re^Vct, Aa^Fpa, Ke, Aa, Rp, Gs, Gs, Gs, Aa, Gs, Aa, Ms, Ms, Ms, Gs, Gs, Gs, Gs
Ai, Ai, Ai, Ai, Ai, Aa, Aa^Fpa, Wwrg, Wwrg, Gd^Vhr, Aa, Rp, Rp, Ce, Ce, Ce, Rp, Hh, Gs, Gs, Aa, Aa, Gs, Gs, Gs, Aa^Vca, Gs, Hh, Hh, Gs
Ai, Ai, Ai, Ai, Wwg, Ai, Wwg, Wwrg, Wwrg, Gs, Gs, Gs, Gs, Rp, Rp, Gll^Fp, Rp, Aa, Aa, Gll^Fp, Hh, Gs, Aa, Hh, Aa, Gs, Gs, Aa, Gs, Gs
Ww, Ww, Ww, Wwg, Wwg, Wwg, Wwg, Wwg, Ai, Gs, Gs, Gs, Gs, Gs, Gs, Rp, Aa^Vha, Aa, Aa, Gs, Gs, Gs, Gs, Gs, Aa^Fpa, Gs, Gs, Aa^Fpa, Aa^Fpa, Gs
Wwg, Wwg, Wwg, Wwg, Wwg, Wwrg, Ai, Ai, Gs, Gs, Gs, Gs, Aa, Gs, Aa, Rp, Gs, Aa, Gs, Gs, Gs, Aa, Aa, Aa^Fpa, Aa^Fpa, Aa, Gs, Aa^Fpa, Hh, Gs
Wog, Wog, Wog, Wwg, Wwg, Wwg, Wwrg, Chw, Khw, Gs, Gs, Gs, Gs, Aa, Aa, Rp, Rp, Gs, Gs, Gll^Fp, Gs, Gs, Gs, Aa^Fpa, Gs, Gs, Gs, Gs, Gs, Gs
Wog, Wog, Wog, Wog, Wog, Wwg, Wwg, Chw, Chw, Re^Vct, Gs, Gs, Ds, Aa, Gs, Gs, Gs, Rp, Rp, Gs, Aa, Gs, Gs, Ha, Gs, Aa, Gs, Aa, Gs, Gs
Wog, Wog, Wog, Wog, Wog, Wwg, Wwg, Wwg, Wwg, Chr, Ai, Ds, Ai, Ds, Ds, Gs, Gll^Fp, Gs, Rp, Gd^Vhr, Gs, Gs, Gs, Ha, Gs, Gs, Gs, Aa, Aa, Gs
Wog, Wog, Wog, Wog, Wog, Wog, Ww^Vm, Wwg, Wwg, Wwg, Wwrg, Ai, Wwg, Ai, Ai, Gs, Gs, Gs, Aa, Rp, Gs, Hh, Aa, Gs, Gs, Aa^Fpa, Gs, Hh, Aa, Gs
Wog, Wog, Wog, Wog, Wog, Wog, Wwrg, Wog, Wog, Wwg, Wwg, Wwg, Wwrg, Wwg, Wwg, Ai, Gs, Aa, Gs, Rp, Rp, Aa, Gs, Gs, Hh, Gs, Gs, Gs, Aa^Fpa, Gs
Wog, Wog, Wog, Wog, Wog, Wog, Wog, Wwrg, Wog, Wwrg, Wog, Wwg, Wwg, Wwg, Wwg, Ai, Ai, Aa, Gs, Aa, Gs, Rp, Gs, Aa, Aa, Hh, Gs, Gs, Aa^Fpa, Gs
Wog, Wog, Wog, Ww^Vm, Wwrg, Wog, Wog, Wog, Wwrg, Wwrg, Wog, Wog, Wwg, Wwrg, Wwg, Wwg, Ai, Gs, Gll^Fp, Gs, Aa, Rp, Gs, Aa^Fpa, Gs, Aa, Gs, Aa, Aa, Gs
Wog, Wog, Wog, Wog, Wwrg, Wog, Wog, Wog, Wog, Wog, Wog, Wog, Wwg, Wwg, Wwg, Wwrg, Wwg, Ai, Ai, Gs, Aa, Rp, Rp, Gs, Gs, Gs, Gs, Gs, Gs, Aa
Wog, Wog, Wog, Wog, Wog, Wog, Wog, Wog, Wog, Wog, Wog, Wog, Wog, Wwrg, Wwg, Wwg, Wwg, Wwg, Ai, Gs, Aa, Aa, Gs, Rp, Ce, Re^Vct, Gs, Gs, Hh, Gs
Wog, Wog, Wog, Ww^Vm, Cme, Wog, Wog, Wog, Wog, Wog, Wog, Wog, Wog, Wwg, Wwg, Wwrg, Wwg, Wwg, Wwrg, Ai, Ai, Aa, Gs, Rp, Ce, Ce, Gs, Hh, Aa, Gs
Wog, Wog, Wwrg, Cme, Kme, Cme, Ww^Vm, Wog, Wog, Wog, Wwg, Wog, Wog, Wog, Wog, Wwg, Wwg, Wwg, Wwg, Wwg, Wwg, Ai, Hh, Rp, Gs, Ke, Gs, Gs, Gs, Gs
Wog, Wog, Wog, Wog, Wwrg, Wog, Wog, Wog, Wog, Wwg, Ds^Ewsh, Wwg, Wog, Wog, Wog, Wog, Wog, Wwg, Wwg, Wwg, Wwg, Ai, Gs, Rp, Gs, Gs, Aa, Gs, Gs, Gs
Wog, Wog, Wog, Wog, Wog, Wwrg, Wog, Wog, Wog, Wwg, Wwg, Wwg, Wog, Wog, Wog, Wog, Wog, Wwg, Wwg, Wwg, Wwg, Ai, Gs, Rp, Gs, Aa, Aa, Gs, Hh, Gs
Wog, Wog, Wog, Wog, Wog, Wog, Wog, Wog, Wog, Wog, Wog, Wog, Wog, Wog, Wog, Wog, Wog, Wwg, Wwg, Wwg, Wwg, Ai, Gs, Rp, Gs, Gs, Gs, Gs, Gs, Gs
