Wog, Wog, Wog, Wog, Wog, Wog, Wog, Wog, Wog, Wog, Wog, Wog, Wog, Wog, Wog, Wog, Wog, Wog, Wog, Wog, Wog, Wog, Wog, Wog, Wog, Wog, Wog, Wog, Wog, Wog, Wog
Wog, Wog, Wog, Wog, Wog, Wog, Wog, Wog, Wog, Wog, Wog, Wog, Wog, Wog, Wog, Wog, Wog, Wog, Wog, Wog, Wog, Wog, Wog, Wog, Wog, Wog, Wog, Wog, Wog, Wog, Wog
Wog, Wog, Wog, Wog, Wog, Wog, Chw, Wog, Wog, Wog, Wog, Wog, Wog, Wog, Wog, Wog, Wog, Wog, Wog, Wog, Wog, Wog, Wog, Wog, Wog, Wog, Wwrg, Wog, Wog, Wog, Wog
Wog, Wog, Wog, Wog, Wog, Chw, Khw, Chw, Wog, Wog, Wog, Wog, Wog, Wog, Wog, Wog, Wog, Wwrg, Wog, Wog, Ww^Vm, Wog, Wog, Wwrg, Wog, Wog, Wog, Wog, Wog, Wog, Wog
Wog, Wog, Wog, Wog, Wog, Chw, Chw, Chw, Wog, Wog, Wog, Wog, Wog, Wog, Wog, Wog, Wog, Wog, Wog, Wog, Wog, Wog, Wog, Wog, Wog, Wog, Wog, Wog, Wog, Wog, Wog
Wog, Wog, Wog, Wog, Wog, Wog, Wog, Wog, Wog, Wog, Wog, Wog, Wog, Wog, Wog, Wog, Wog, Wog, Wog, Wog, Wog, Wog, Wwrg, Wog, Wog, Wog, Wog, Wog, Wog, Ww^Vm, Wog
Wog, Wog, Wog, Wog, Wog, Wog, Wog, Wog, Wog, Wog, Wog, Wog, Wog, Wog, Wog, Wog, Wog, Wog, Wog, Wog, Wog, Wog, Wog, Wog, Wog, Wog, Wog, Wog, Wwg, Wog, Wwg
Wog, Wog, Wog, Wog, Wog, Wog, Wog, Wog, Wog, Wog, Wog, Wog, Wog, Wog, Wog, Wog, Wog, Wog, Wog, Wog, Wwrg, Wog, Wwg, Wwg, Wwg, Wwg, Wwg, Wwg, Wwg, Wwg, Wwg
Wog, Wog, Wog, Wog, Wog, Wog, Wog, Wog, Wog, Wog, Wog, Wog, Wog, Wog, Wog, Wog, Wwg^Bw\r, Wog, Wwg, Wwg, Ai, Wwg, Ai, Ai, Ai, Ai, Ai, Ai, Ai, Ai, Ai
Wog, Wog, Wog, Wog, Wog, Wog, Wog, Wog, Wog, Wog, Wog, Wog, Wwg, Wog, Wwg, Wwg, Wwg, Wwg^Bw\r, Rra, Ai, Ai, Ai, Aa, Ai, Aa, Aa, Aa, Aa, Aa, Aa, Aa
Wog, Wog, Wog, Wog, Wog, Wog, Wog, Wog, Wog, Wog, Wwg, Wwg, Wwg, Wwg, Wwg, Wwg, Ai, Ai, Rra, Aa, Aa, Aa, Cea, Aa, Aa, Aa^Fpa, Gs, Gs, Gs, Gs, Gs
Wog, Wog, Ww^Vm, Wog, Wog, Wog, Wog, Wog, Wog, Wog, Wwg, Wwg, Wwg, Wwg, Ai, Ai, Gs, Gs, Gs, Rra, Cea, Kea, Cea, Re^Vct, Aa, Gs, Aa, Aa, Aa, Gs, Gs
Wog, Wog, Wog, Wog, Wog, Wog, Wog, Wog, Wog, Wwrg, Wwg, Wwg, Ai, Ai, Gs, Gs, Gs, Gs, Gs, Rra, Gs, Cea, Gs, Gs, Gs, Gs, Gs, Aa, Gs, Gs, Aa
Wog, Wog, Wog, Wog, Wog, Wog, Wog, Wog, Wog, Wwg, Ai, Ai, Gs, Gs, Gs, Aa, Aa, Gs, Rra, Rra, Gs, Gs, Aa, Aa, Gs, Gs, Aa, Aa^Fpa, Aa, Aa, Aa
Wog, Wog, Wog, Wog, Wog, Wog, Wog, Wog, Wog, Wwg, Ai, Gs, Aa, Gs, Gs, Gs, Gs, Gs, Rra, Aa^Vha, Aa, Gs, Aa, Gs, Aa, Aa, Aa, Aa, Gs, Aa, Gs
Wog, Wog, Wog, Wog, Wog, Wog, Wog, Wog, Wog, Wwg, Ai, Gs, Aa, Aa^Fpa, Aa, Aa, Rra, Rra, Gs, Gs, Aa, Gs, Aa, Aa, Gs, Aa, Aa, Aa, Aa, Gs, Gs
Wog, Wog, Wog, Wog, Wog, Wog, Wog, Wog, Wog, Wwg, Ai, Gs, Aa, Aa, Aa, Aa^Fpa, Rra, Gs, Gs, Gs, Gs, Gs, Gs, Gs, Aa, Gs, Gs, Gs, Gs, Gs, Aa
Wog, Wog, Wog, Wog, Wog, Wog, Wog, Wog, Wwg, Wwg, Ai, Gs, Gs, Aa, Gd^Vhr, Rra, Gs, Gs, Aa, Aa, Gs, Gs, Aa, Gs, Aa, Gs, Aa, Gs, Gs, Aa, Aa
Wog, Wog, Wwrg, Cme, Wog, Wog, Wog, Wog, Wwg, Wwg, Ai, Aa, Gs, Gs, Rra, Rra, Aa, Gs, Gs, Aa^Fpa, Aa, Aa, Gs, Gs, Gs, Gs, Aa, Aa, Gs, Aa, Aa
Wog, Wwrg, Cme, Kme, Cme, Wwrg, Wog, Wog, Wwg, Wwg, Ai, Gs, Gs, Gs, Rra, Gs, Aa, Gs, Gs, Aa, Gs, Gs, Gs, Aa, Gs, Aa, Gs, Gs, Gs, Aa^Fpa, Gs
Wog, Wog, Wog, Cme, Wog, Wog, Wog, Wog, Wwg, Ai, Gs, Gs, Aa, Gs, Rra, Gs, Gs, Aa, Aa, Aa, Aa, Gs, Aa^Fpa, Gs, Gs, Aa, Aa, Gs, Aa, Gs, Gs
Wog, Wog, Wog, Wog, Wog, Wog, Wog, Wwg, Ai, Ai, Gs, Aa^Fpa, Aa, Aa, Ce, Ce, Ce, Gs, Gs, Aa, Aa, Gs, Aa, Aa, Gs, Gs, Aa, Aa, Aa, Gs, Gs
Wog, Wog, Wog, Wog, Wog, Wog, Wog, Wwg, Ai, Gs, Gs, Gs, Gs, Rra, Aa^Vha, Ke, Gs, Gs, Aa, Gs, Gs, Gs, Gs, Aa, Aa, Gs, Gs, Aa, Aa^Fpa, Gs, Gs
Wog, Wog, Wog, Wog, Wog, Wog, Wwg, Wwg, Ai, Gs, Gs, Aa, Gs, Rra, Gs, Gs, Aa, Gs, Aa, Gs, Aa, Aa, Aa, Gs, Aa, Aa, Gs, Aa, Gs, Gs, Gs
