Wog, Wog, Wog, Wog, Wog, Wog, Wog, Wog, Wog, Wog, Wog, Wog, Wog, Wog, Wog, Wog, Wog, Wog, Wog, Wog, Wog, Wog, Wog, Wog, Wog, Wog, Wog, Wog, Wog, Wog, Wog, Wog, Wog, Wog, Wog, Wog
Wog, Wog, Wog, Wog, Wog, Wog, Wog, Wog, Wog, Wog, Wog, Wog, Wog, Wog, Wog, Wog, Wog, Wog, Wog, Wog, Wog, Wog, Wog, Wog, Wog, Wog, Wog, Wog, Wog, Wog, Wog, Wog, Wog, Wog, Wog, Wog
Wog, Wog, Wog, Wog, Wog, Wog, Wog, Wog, Wog, Chw, Wog, Wog, Wog, Wog, Wog, Wog, Wog, Wog, Wog, Wog, Wog, Wog, Wog, Wog, Wog, Wog, Wog, Wog, Wog, Wwrg, Wog, Wog, Wog, Wog, Wog, Wog
Wog, Wog, Wog, Wog, Wog, Wog, Wog, Wog, Chw, Khw, Chw, Wog, Wog, Wog, Wog, Wog, Wog, Wog, Wog, Wog, Wwrg, Wog, Wog, Ww^Vm, Wog, Wog, Wwrg, Wog, Wog, Wog, Wog, Wog, Wog, Wog, Wog, Wog
Wog, Wog, Wog, Wog, Wog, Wog, Wog, Wog, Chw, Chw, Chw, Wog, Wog, Wog, Wog, Wog, Wog, Wog, Wog, Wog, Wog, Wog, Wog, Wog, Wog, Wog, Wog, Wog, Wog, Wog, Wog, Wog, Wog, Wog, Wog, Wog
Wog, Wog, Wog, Wog, Wog, Wog, Wog, Wog, Wog, Wog, Wog, Wog, Wog, Wog, Wog, Wog, Wog, Wog, Wog, Wog, Wog, Wog, Wog, Wog, Wog, Wwrg, Wog, Wog, Wog, Wog, Wog, Wog, Ww^Vm, Wog, Wog, Wog
Wog, Wog, Wog, Wog, Wog, Wog, Wog, Wog, Wog, Wog, Wog, Wog, Wog, Wog, Wog, Wog, Wog, Wog, Wog, Wog, Wog, Wog, Wog, Wog, Wog, Wog, Wog, Wog, Wog, Wog, Wog, Wwg, Wog, Wwg, Wwg, Wwg
Wog, Wog, Wog, Wog, Wog, Wog, Wog, Wog, Wog, Wog, Wog, Wog, Wog, Wog, Wog, Wog, Wog, Wog, Wog, Wog, Wog, Wog, Wog, Wwrg, Ai, Wwg, Wwg, Wwg, Ai, Wwg, Ai, Wwg, Ai, Wwg, Wwg, Wwg
Wog, Wog, Wog, Wog, Wog, Wog, Wog, Wog, Wog, Wog, Wog, Wog, Wog, Wog, Wog, Wog, Wog, Wog, Wog, Wwg^Bw\r, Ai, Wwg, Ai, Ai, Aa, Ai, Ai, Ai, Aa, Ai, Aa, Ai, Aa, Ai, Ai, Ai
Wog, Wog, Wog, Wog, Wog, Wog, Wog, Wog, Wog, Wog, Wog, Wog, Wog, Wog, Wog, Wog, Wog, Wog, Wwg, Wwg, Wwg^Bw\r, Rra, Ai, Aa, Aa, Aa, Aa, Aa, Gs, Aa, Aa, Aa, Gs, Aa, Rra, Rra
Wog, Wog, Wog, Wog, Wog, Wog, Wog, Wog, Wog, Wog, Wog, Wog, Wog, Wog, Wog, Wog, Wwg, Wwg, Ai, Ai, Gs, Rra, Aa, Aa, Aa, Cea, Aa, Aa, Aa^Fpa, Gs, Gs, Gs, Gs, Rra, Gs, Gs
Wog, Wog, Wog, Wog, Wog, Ww^Vm, Wog, Wog, Wog, Wog, Wog, Wog, Wog, Wog, Wwg, Wwg, Ai, Ai, Gs, Gs, Gs, Gs, Rra, Cea, Kea, Cea, Re^Vct, Aa, Rra, Aa, Gs, Aa, Gs, Rra, Ha, Gs
Wog, Wog, Wog, Wog, Wog, Wog, Wog, Wog, Wog, Wog, Wog, Wog, Wwrg, Wwg, Wwg, Ai, Gs, Gs, Gs, Gs, Gs, Gs, Rra, Gs, Cea, Gs, Rra, Rra, Gs, Rra, Aa, Rra, Gs, Aa, Aa, Aa
Wog, Wog, Wog, Wog, Wog, Wog, Wog, Wog, Wog, Wog, Wog, Wog, Wwg, Ai, Gs, Gs, Gs, Gs, Aa, Aa, Gs, Rra, Rra, Gs, Gs, Aa, Aa, Gs, Gs, Aa, Aa^Fpa, Aa, Aa, Gs, Aa, Aa
Wog, Wog, Wog, Wog, Wog, Wog, Wog, Wog, Wog, Wog, Wog, Wog, Wwg, Ai, Gs, Aa, Gs, Gs, Gs, Gs, Gs, Rra, Aa^Vha, Aa, Gs, Aa, Gs, Aa, Aa, Gs, Aa, Gs, Gs, Gs, Gs, Gs
Wog, Wog, Wog, Wog, Wog, Wog, Wog, Wog, Wog, Wog, Wog, Wog, Wwg, Ai, Gs, Aa, Aa^Fpa, Aa, Aa, Rra, Rra, Gs, Gs, Aa, Gs, Aa, Aa, Gs, Aa, Gs, Gs, Aa, Gs, Aa^Fpa, Aa^Fpa, Gs
Wog, Wog, Wog, Wog, Wog, Wog, Wog, Wog, Wog, Wog, Wog, Wog, Wwg, Ai, Gs, Aa, Aa, Aa, Aa^Fpa, Rra, Gs, Gs, Gs, Gs, Gs, Gs, Gs, Aa, Gs, Gs, Gs^Vhr, Gs, Gs, Aa^Fpa, Aa, Aa
Wog, Wog, Wog, Wog, Wog, Wog, Wog, Wog, Wog, Wog, Wog, Wog, Wwg, Ai, Gs, Gs, Aa, Gd^Vhr, Rra, Gs, Gs, Aa, Aa, Gs, Gs, Aa, Gs, Aa, Gs, Aa, Ha, Gs, Aa, Gs, Aa, Aa
Wog, Wog, Wog, Wog, Wog, Wwrg, Cme, Wog, Wog, Wog, Wog, Wwg, Wwg, Ai, Aa, Gs, Gs, Rra, Rra, Aa, Gs, Gs, Aa^Fpa, Aa, Aa, Gs, Gs, Gs, Gs, Aa, Aa, Gs, Aa, Gs, Aa, Aa
Wog, Wog, Wog, Wog, Wwrg, Cme, Kme, Cme, Wwrg, Wog, Wog, Wwg, Wwg, Ai, Gs, Gs, Gs, Rra, Gs, Aa, Gs, Gs, Aa, Gs, Gs, Gs, Aa, Gs, Aa, Gs, Gs, Gs, Aa^Fpa, Gs, Gs, Aa^Fpa
Wog, Wog, Wog, Wog, Wog, Wog, Cme, Ww^Vm, Wog, Wog, Wog, Wwg, Ai, Gs, Gs, Aa, Gs, Rra, Gs, Gs, Aa, Aa, Aa, Aa, Gs, Aa^Fpa, Gs, Gs, Aa, Aa, Gs, Aa, Gs, Gs, Gs, Gs
Wog, Wog, Wog, Wog, Wog, Wog, Wog, Wog, Wog, Wog, Wwg, Ai, Ai, Gs, Aa^Fpa, Aa, Aa, Rra, Rra, Gs, Gs, Gs, Aa, Aa, Gs, Aa, Aa, Gs, Gs, Aa, Aa, Aa, Gs, Ha, Aa, Gs
Wog, Wog, Wog, Wog, Wog, Wog, Wog, Wog, Wog, Wog, Wwg, Ai, Gs, Gs, Gs, Gs, Gs, Aa^Vha, Rra, Gs, Gs, Aa, Gs, Gs, Gs, Gs, Aa, Aa, Aa^Fpa, Gs, Aa, Aa^Fpa, Gs, Ha, Aa, Gs
Wog, Wog, Wog, Wog, Wog, Wog, Wog, Wog, Wog, Wwg, Wwg, Ai, Gs, Gs, Aa, Gs, Gs, Rra, Gs, Aa, Gs, Aa, Gs, Aa, Gs, Aa, Gs, Gs, Gs, Gs, Aa, Gs, Gs, Aa, Gs, Gs
Wog, Wog, Wog, Wog, Wog, Wog, Wog, Wog, Wog, Wwg, Wwg, Ai, Gs, Gs, Aa, Gs, Rra, Rra, Gs, Gs, Gs, Gs, Gs, Gs, Aa, Gs, Gs, Gs, Aa^Fpa, Gs, Gs, Gs, Gs, Aa, Gs, Gs
Wog, Wog, Wog, Wog, Wog, Wog, Wog, Wog, Wog, Wwg, Wwg, Ai, Gs, Gs, Aa, Gs, Rra, Gs, Gs, Gs, Gs, Gs, Gs, Gs, Gs, Aa, Gs, Aa, Aa^Fpa, Gs, Aa^Fpa, Gs, Gs, Gs, Gs, Gs
Wog, Wog, Wog, Wog, Wog, Wog, Wog, Wog, Wog, Wwg, Wwg, Ai, Gs, Gs, Gs, Gs, Rra, Ce, Ce, Ce, Gs, Gs, Gs, Aa, Gs, Aa, Gs, Aa^Fpa, Gs, Gs, Aa, Aa^Fpa, Aa, Aa, Gs, Gs
Wog, Wog, Wog, Wog, Wog, Wog, Wog, Wog, Wog, Wwg, Wwg, Ai, Gs, Gs, Aa, Gs, Rra, Aa^Vha, Ke, Ce, Gs, Gs, Gs, Gs, Aa, Aa, Gs, Gs, Gs, Aa, Aa, Aa, Gs, Gs, Hh, Gs
Wog, Wog, Wog, Wog, Wog, Wog, Wog, Wog, Wog, Wwg, Wwg, Ai, Gs, Gs, Gs, Gs, Gs, Rra, Gs, Gs, Gs, Gs, Gs, Aa, Gs, Gs, Aa^Fpa, Gs, Aa, Gs, Gs, Gs, Gs, Aa^Vha, Aa, Gs
Wog, Wog, Wog, Wog, Wog, Wog, Wog, Wog, Wog, Wwg, Wwg, Ai, Gs, Gs, Gs, Gs, Gs, Rra, Gs, Gs, Gs, Gs, Gs, Gs, Gs, Gs, Gs, Gs, Gs, Gs, Aa, Aa^Fpa, Gs, Aa, Gs, Gs
