Xoa, Xoa, Xoa, Xoa, Xoa, Xoa, Xoa, Xoa, Wwg, Ias, Wwg, Xoa, Xoa, Xoa, Xoa, Xoa, Xoa, Xoa, Xoa, Xoa
Xoa, Xoa, Xoa, Xoa, Xoa, Xoa, Xoa, Xoa, Wwg, Ias, Wwg, Xoa, Xoa, Xoa, Xoa, Xoa, Xoa, Xoa, Xoa, Xoa
Xoa, Xoa, Xoa, Xoa, Xoa, Xoa, Xoa, Xoa, Wwg, Ias, Wwg, Xoa, Xoa, Xoa, Xoa, Xoa, Xoa, Xoa, Xoa, Xoa
Xoa, Xoa, Xoa, Xoa, Xoa, Xoa, Xoa, Xoa, Wwg, Ias, Wwg, Xoa, Xoa, Xoa, Xoa, Xoa, Xoa, Xoa, Xoa, Xoa
Xoa, Xoa, Xoa, Xoa, Xoa, Xoa, Wwg, Wwg, Ias, Ias, Ias, Wwg, Wwg, Xoa, Xoa, Xoa, Xoa, Xoa, Xoa, Xoa
Xoa, Xoa, Xoa, Xoa, Xoa, Xoa, Wwg, Ias, Ias, Ias, Ias, Ias, Wwg, Xoa, Xoa, Xoa, Xoa, Xoa, Xoa, Xoa
Ias, Ias, Ias, Ias, Ias, Ias, Wwg, Ias, Ias, Ias, Ias, Ias, Wwg, Ias, Ias, Ias, Ias, Ias, Ias, Ias
Ias, Ias, Ias, Ias, Ias, Ias, Ias, Wwg^Bsb/, Wwg, Ias, Wwg, Wwg^Bsb\, Ias, Ias, Ias, Ias, Ias, Ias, Ias, Ias
Xoa, Ias, Xoa, Ias, Xoa, Ias, Ias, Ias, Ias, Wwg, Ias, Ias, Ias, Ias, Xoa, Ias, Xoa, Ias, Xoa, Ias
Xoa, Xoa, Xoa, Xoa, Xoa, Xoa, Xoa, Ias, Ias, Wwg, Ias, Ias, Xoa, Xoa, Xoa, Xoa, Xoa, Xoa, Xoa, Xoa
Xoa, Xoa, Xoa, Xoa, Xoa, Xoa, Xoa, Ias, Ias, Wwg, Ias, Ias, Xoa, Xoa, Xoa, Xoa, Xoa, Xoa, Xoa, Xoa
Xoa, Xoa, Xoa, Xoa, Xoa, Xoa, Xoa, Ias, Ias, Wwg, Ias, Ias, Xoa, Xoa, Xoa, Xoa, Xoa, Xoa, Xoa, Xoa
Xoa, Xoa, Xoa, Xoa, Xoa, Xoa, Xoa, Ias, Ias, Wwg, Ias, Ias, Xoa, Xoa, Xoa, Xoa, Xoa, Xoa, Xoa, Xoa
Xoa, Xoa, Xoa, Xoa, Xoa, Xoa, Xoa, Ias, Ias, Wwg, Ias, Ias, Xoa, Xoa, Xoa, Xoa, Xoa, Xoa, Xoa, Xoa
