Xoa, Xoa, Xoa, Xoa, Xoa, Xoa, Xoa, Xoa, Wwg, Isa, Wwg, Xoa, Xoa, Xoa, Xoa, Xoa, Xoa, Xoa, Xoa, Xoa
Xoa, Xoa, Xoa, Xoa, Xoa, Xoa, Xoa, Xoa, Wwg, Isa, Wwg, Xoa, Xoa, Xoa, Xoa, Xoa, Xoa, Xoa, Xoa, Xoa
Xoa, Xoa, Xoa, Xoa, Xoa, Xoa, Xoa, Xoa, Wwg, Isa, Wwg, Xoa, Xoa, Xoa, Xoa, Xoa, Xoa, Xoa, Xoa, Xoa
Xoa, Xoa, Xoa, Xoa, Xoa, Xoa, Xoa, Xoa, Wwg, Isa, Wwg, Xoa, Xoa, Xoa, Xoa, Xoa, Xoa, Xoa, Xoa, Xoa
Xoa, Xoa, Xoa, Xoa, Xoa, Xoa, Wwg, Wwg, Isa, Isa, Isa, Wwg, Wwg, Xoa, Xoa, Xoa, Xoa, Xoa, Xoa, Xoa
Xoa, Xoa, Xoa, Xoa, Xoa, Xoa, Wwg, Isa, Isa, Isa, Isa, Isa, Wwg, Xoa, Xoa, Xoa, Xoa, Xoa, Xoa, Xoa
Isa, Isa, Isa, Isa, Isa, Isa, Wwg, Isa, Isa, Isa, Isa, Isa, Wwg, Isa, Isa, Isa, Isa, Isa, Isa, Isa
Isa, Isa, Isa, Isa, Isa, Isa, Isa, Wwg^Bsb/, Wwg, Isa, Wwg, Wwg^Bsb\, Isa, Isa, Isa, Isa, Isa, Isa, Isa, Isa
Xoa, Isa, Xoa, Isa, Xoa, Isa, Isa, Isa, Isa, Wwg, Isa, Isa, Isa, Isa, Xoa, Isa, Xoa, Isa, Xoa, Isa
Xoa, Xoa, Xoa, Xoa, Xoa, Xoa, Xoa, Isa, Isa, Wwg, Isa, Isa, Xoa, Xoa, Xoa, Xoa, Xoa, Xoa, Xoa, Xoa
Xoa, Xoa, Xoa, Xoa, Xoa, Xoa, Xoa, Isa, Isa, Wwg, Isa, Isa, Xoa, Xoa, Xoa, Xoa, Xoa, Xoa, Xoa, Xoa
Xoa, Xoa, Xoa, Xoa, Xoa, Xoa, Xoa, Isa, Isa, Wwg, Isa, Isa, Xoa, Xoa, Xoa, Xoa, Xoa, Xoa, Xoa, Xoa
Xoa, Xoa, Xoa, Xoa, Xoa, Xoa, Xoa, Isa, Isa, Wwg, Isa, Isa, Xoa, Xoa, Xoa, Xoa, Xoa, Xoa, Xoa, Xoa
Xoa, Xoa, Xoa, Xoa, Xoa, Xoa, Xoa, Isa, Isa, Wwg, Isa, Isa, Xoa, Xoa, Xoa, Xoa, Xoa, Xoa, Xoa, Xoa
