Rp, Gs, Gs, Gs, Gs, Wwg, Wwg, Wwg, Wog, Wog, Wog, Wog, Wog, Wog, Wog, Wog, Wog, Wog, Wog, Wog, Wog, Wog, Wog, Wog, Wog, Wog, Wog
Gs, Rp, Rp, Gs, Wwg, Wwg, Wog, Wog, Wwg, Wog, Wog, Wog, Wog, Wog, Wog, Wog, Wog, Wog, Wog, Wog, Wog, Wog, Wog, Wog, Wog, Wog, Wog
Gs, Aa, Wwg, Wwg^Bsb\, Wwg^Bsb\, Wog, Wwg, Wwg, Gs, Wwg, Wwg, Wwg, Wwg, Wwg, Wwg, Wwg, Wwg, Wwg, Wwg, Wog, Wog, Wog, Wog, Wog, Wog, Wog, Wog
Wwg, Wwg, Wog, Wog, Wwg, Wwg^Bsb\, Rr, Ch, Gs, Gs, Gs, Gll^Fp, Gll^Fp, Gll^Fp, Gll^Fp, Gs, Gs^Eff, Gs, Gs, Wwg, Wwg, Wog, Wog, Wog, Wog, Wog, Wog
Wog, Wog, Wog, Wwg, Ww, Ch, Rr, Gs, Gs, Aa, Gs, Gs, Gll^Fp, Gll^Fp, Gs^Eff, Gs^Eff, Gs, Gs^Eff, Gs^Eff, Gs, Gs, Wwg, Wwg, Wog, Wog, Wog, Wog
Wog, Wog, Wog, Wog, Ww, Gs, Rr, Gs, Gs, Gs, Gs, Gs, Gs^Eff, Gs^Eff, Gs, Gs, Gs, Gs, Rb^Eff, Rb^Eff, Rb^Eff, Gs, Gs, Wwg, Wwg, Wog, Wog
Wog, Wog, Wog, Wog, Ww, Gs, Gs, Rr, Rr, Gs, Gs, Gs, Gll^Fp, Gs^Eff, Rr, Gs, Rb, Rb^Eff, Rb^Gvs, Rb^Gvs, Rb^Gvs, Rb^Eff, Rb^Eff, Gs, Gs, Wog, Wog
Wog, Wog, Wog, Wog, Wog, Ww, Gll^Fp, Gs, Gs, Rr, Rr, Gll^Fp, Gll^Fp, Gs^Vh, Rr, Rb, Rb^Eff, Rb^Gvs, Rb^Gvs, Rb^Gvs, Rb^Wm, Rb^Gvs, Rb^Gvs, Rb^Eff, Rb^Eff, Wog, Wog
Wog, Wog, Wog, Wog, Wog, Ww, Gs, Gll^Fp, Gs, Aa, Gll^Fp, Rr, Rr, Rr, Gs, Gs, Gs^Vh, Rb^Eff, Rb^Eff, Rb^Gvs, Rb^Gvs, Rb^Gvs, Rb^Eff, Rb^Eff, Gll^Fp, Wog, Wog
Wog, Wog, Wog, Wog, Wog, Ww, Gs, Gs, Gs^Vh, Gs, Rr, Rr, Rr, Gs^Vh, Rr, Rr, Rr, Gs, Aa, Rb^Eff, Rb, Rb^Eff, Gs, Gll^Fp, Wwg, Wog, Wog
Wog, Wog, Wog, Wog, Wog, Ww, Ww, Gs, Rr, Rr, Gs, Gs, Gs, Rr, Gs, Gll^Fp, Gs, Rr, Rr, Gs, Gs, Gs, Gs, Gll^Fp, Wwg, Wog, Wog
Wog, Wog, Wog, Wog, Wog, Wog, Wog^Bw/, Ww^Bw/, Gs, Gs, Gs, Gll^Fp, Gs, Rr, Gs, Gll^Fp, Gs, Ch, Ch, Kh, Ch, Ch, Aa, Gll^Fp, Wwg, Wog, Wog
Wog, Wog, Wog, Wog, Wog, Wog, Wog, Wwg, Wwg, Gs, Ch, Gs, Rr, Rr, Gs, Gs, Wwg, Gs, Gs, Ch, Gs, Gs, Wwg, Wwg, Wog, Wog, Wog
Wog, Wog, Wog, Wog, Wog, Wog, Wog, Wog, Wog, Wwg, Wog^Bsb/, Rr, Ch, Gs, Wwg, Wwg, Wog, Wwg, Wog, Wwg, Wog, Wwg, Wog, Wog, Wog, Wog, Wog
Wog, Wog, Wwg, Wog, Gll^Fp, Wog, Gs, Wog, Gs, Wog^Bsb/, Wog, Wwg, Wwg, Wwg, Wog, Wog, Wog, Wog, Wog, Wog, Wog, Wog, Wog, Wog, Wog, Wog, Wog
Gs, Gs, Gs, Gs, Aa, Gs, Aa, Gs, Aa, Gs, Wog, Wog, Wog, Wog, Wog, Wog, Wog, Wog, Wog, Wog, Wog, Wog, Wog, Wog, Wog, Wog, Wog
