Gs, Gs, Gll^Fp, Gs, Gll^Fp, Gs, Gll^Fp, Gs, Gs, Gs, Gs, Gs, Gs, Gs, Gs, Gs, Gs, Gs, Gs, Gs, Gs, Gs, Gs, Gs, Gs, Gs, Gs, Gs, Gs, Gs, Wwg, Gs, Gs, Gs, Gs, Gs, Gs, Gs, Gs, Gs, Gs, Gs, Gs, Gs, Gs, Gs, Gs, Gs, Gs, Gs, Gs, Gs
Gs, Gll^Fp, Gll^Fp, Gll^Fp, Gll^Fp, Gll^Fp, Gll^Fp, Gll^Fp, Gs, Gs, Gll^Fp, Gs, Aa, Gs, Aa^Fpa, Gs, Gs, Gs, Gll^Fp, Gs, Gll^Fp, Gs, Gs, Gs, Gs, Gs, Gs, Gs, Gll^Fp, Gs, Wwg, Gs, Gs, Gs, Gs, Gs, Gs, Gs, Gs, Gs, Gs, Aa, Gs, Gs, Gs, Gll^Fp, Gs, Gs, Gll^Fp, Gs, Gs, Gs
Gll^Fp, Gll^Fp, Gll^Fp, Gs, Gs, Gs, Gs, Gs, Aa, Gll^Fp, Gll^Fp, Gs, Gs, Gll^Fp, Gll^Fp, Gll^Fp, Aa, Gll^Fp, Gs, Gs, Gll^Fp, Gll^Fp, Gs, Gll^Fp, Gs, Gs, Gs, Gs, Gs, Gs, Ai, Gs, Gs, Gll^Fp, Gs, Gs, Gs, Gll^Fp, Gs, Gs, Gll^Fp, Gs, Hh, Hh, Gs, Gs, Gs, Gs, Gs, Gs, Gs, Gs
Gs, Gll^Fp, Gs, Aa, Gs, Gll^Fp, Gs, Gs, Gs, Gs, Gs, Gll^Fp, Gs, Gll^Fp, Gs, Aa^Fpa, Gs, Gs, Gs, Gll^Fp, Gs, Gs, Gs, Gs, Gs, Gs, Gll^Fp, Gs, Aa, Gs, Ai, Aa, Gs, Gs, Gs, Gs, Gs, Gs, Gs, Gs, Gs, Gs, Hh, Gs, Gs, Gs, Gs, Gs, Gs, Aa, Gs, Gll^Fp
Gs, Gs, Gll^Fp, Gll^Fp, Gs, Gll^Fp, Ce, Ce, Ce, Gs^Vct, Gs, Gs, Hh, Gs, Gs, Aa, Gs, Gll^Fp, Gs, Gs, Gs, Hh, Hh, Gs, Gs, Gll^Fp, Gs, Aa, Aa, Gs, Wwg, Gs, Gs, Gs, Gll^Fp, Gs, Gs, Aa, Gll^Fp, Gs, Gs, Gs, Gs, Gs, Ce, Ce, Ce, Gs, Gs, Gs, Gs, Gs
Gs, Gs, Gs, Gs, Gs, Gs, Ce, Ke, Ce, Ce, Gs, Gs, Hh^Fp, Hh^Fp, Gs, Gs, Gs, Gs, Gll^Fp, Gs, Gs, Hh, Gs, Gs, Gs, Gs, Gs, Gll^Fp, Gs, Gs, Wwg, Gs, Gs, Gs, Gll^Fp, Gll^Fp, Gs, Gs, Gs, Gs, Gs, Gs, Gs, Re^Vct, Ce, Ke, Ce, Gs, Gs, Gs, Gll^Fp, Gs
Gs, Gll^Fp, Gs, Gs, Gll^Fp, Gs, Gs, Ce, Gs, Gs, Gs, Gs, Gs, Gs, Gs, Gll^Fp, Gll^Fp, Gll^Fp, Gs, Gs, Gs, Gs, Gs, Gll^Fp, Gs, Gs, Gs, Gs, Gs, Gs, Wwg, Gs, Gs, Gs, Gs, Gs, Gs, Gs, Gs, Gs, Gs, Gs, Gs, Gs, Gs, Ce, Gs, Gs, Gs, Gll^Fp, Gll^Fp, Gs
Gll^Fp, Gll^Fp, Gs, Gs, Gs, Gs, Gs, Gs, Gll^Fp, Gll^Fp, Gll^Fp, Gs, Gs, Gs, Gs, Gs, Gs, Gs, Gs, Gs, Gs, Aa, Gs, Gs, Gs, Gs, Aa^Fpa, Gs, Gs, Gs^Vhr, Wwf, Gs, Gs, Gs, Gs, Gs, Aa, Gs, Gs, Hh, Gll^Fp, Gs, Gs, Gs, Gs, Gs, Gs, Gs, Gs, Gs, Gs, Gs
Gll^Fp, Gs, Gll^Fp, Gs, Gs, Gs, Gs, Gs, Gs, Gs, Gll^Fp, Gs, Gs, Gs, Gs, Gs, Gll^Fp, Gs, Gs, Gs, Gs, Gs, Aa^Fpa, Gs, Gs, Gs, Aa, Gll^Fp, Gs, Gs, Wwg, Gs, Gs, Gs, Gs, Gs, Gs, Gs, Gs, Gs, Gs, Gs, Gs, Gs, Gs, Gll^Fp, Gll^Fp, Gs, Aa, Gs, Hh, Gs
Gs, Gs, Gs, Gll^Fp, Gs, Aa, Gll^Fp, Gll^Fp, Gs, Gs, Gs, Gs, Gs, Gll^Fp, Gs, Gll^Fp, Gs^Vct, Gs, Aa, Gs, Gll^Fp, Gll^Fp, Gs, Gs, Gs, Gs, Gs, Gs, Gs, Gs, Wwg, Gs, Gs, Gs, Gs, Gs, Gs, Gs, Gs, Gs, Gs, Gs, Gs, Gs, Gs, Gll^Fp, Gs, Gs, Gs, Aa, Gs, Gs
Gs, Gll^Fp, Gll^Fp, Gs, Gs, Gs, Gs, Gs, Gs, Aa, Gs, Gs, Gs, Gs, Gs, Gs, Gs, Aa, Aa^Fpa, Gs, Gs, Gs, Gs, Gs, Gs, Gs, Gll^Fp, Gs, Gll^Fp, Gs, Wwg, Gs, Gs, Gll^Fp, Gs, Gs, Gs, Gll^Fp, Gs, Gs, Gs, Gll^Fp, Gs, Gs, Gs, Gs, Gs, Gs, Aa, Gs, Gs, Gs
Gs, Gs, Gs, Gs, Gs, Gll^Fp, Gs, Gs, Gll^Fp, Gs, Gs, Gll^Fp, Gll^Fp, Gs, Gs, Gll^Fp, Gll^Fp, Gs, Gs, Gs, Gs, Gs, Aa, Gs, Gs, Gll^Fp, Gll^Fp, Gs, Gs, Gs, Wwg, Gs, Gs, Gs, Gs, Gs, Gs, Gs, Gs, Gs, Gs, Gs, Gs, Gs, Rp, Rp, Rp, Rp, Rp, Rp, Rp, Rp
Gs, Gll^Fp, Gll^Fp, Gs, Gs, Gs, Gs, Gs, Gll^Fp, Gll^Fp, Gs, Gs, Gs, Gs, Gs, Gs, Gs, Gs, Gs, Gs, Gll^Fp, Gs, Gs, Gs, Gs, Gll^Fp, Aa, Gs, Wwg, Wwg, Gs, Gs, Gs, Gs, Gs, Gs, Gs, Aa, Gs, Gs, Gs, Aa, Gs, Gs, Rp, Hhd^Vhhr, Gs, Gs, Hh, Gs, Gs, Gs
Gll^Fp, Gll^Fp, Gs^Vl, Gs, Gll^Fp, Gll^Fp, Gs, Gs, Gs, Gll^Fp, Gs, Gll^Fp, Gll^Fp, Gs, Gs, Gs, Gll^Fp, Gs, Gs, Gs, Gs, Gs, Gs, Gs, Gs, Gs, Gs, Gs, Wwg, Gs, Gs, Aa, Gs, Gs, Gll^Fp, Gs, Gs, Gs, Gll^Fp, Gs, Gs, Gs, Gs, Rp, Gs, Gs, Gs, Hh, Hh, Gs, Gs, Gs
Gll^Fp, Gll^Fp, Gs, Gs, Gs, Gll^Fp, Gs, Gs, Aa, Gs, Gs, Gs, Gs, Gs, Gs, Gll^Fp, Gs, Gll^Fp, Gs, Gs, Aa, Gs, Gs, Gs^Fpa, Gs, Gs, Gs, Gs, Wwg, Gs, Gs, Gs, Gs, Gs, Aa, Gs, Gs, Gll^Fp, Gll^Fp, Gs, Gs, Gs, Rp, Rp, Gs, Gs, Gs, Gs, Gll^Fp, Gs, Gs, Gs
Gs, Gs, Gs, Gll^Fp, Gs, Gll^Fp, Gs, Aa, Gs, Gs, Gs, Gs, Gll^Fp, Gs, Gs, Gs, Gs, Gs, Gs, Gs, Gs, Gs, Gs, Gs, Gs, Gs, Gs, Wwg, Gs, Gs, Gs, Gs, Gs, Gs, Gll^Fp, Gs, Gs, Gs, Gs, Gll^Fp, Gs, Gs, Rp, Aa, Gs, Gs, Gll^Fp, Gs, Gs, Gll^Fp, Gs, Gs
Gs, Gs, Gll^Fp, Gs, Gs, Gs, Gs, Gs, Gs, Gll^Fp, Gs, Gs, Gs, Gll^Fp, Gs, Gs, Aa, Gs, Gll^Fp, Gs, Gs, Gs, Gs, Gs, Gs, Gll^Fp, Gs, Wwg, Gs, Gs, Gs, Gs, Gs, Gs, Gs, Gs, Gs, Gs, Gs, Gs, Gs, Rp, Gs, Gs, Mm, Gs, Hh, Gs, Hh, Gs, Gs, Gs
Gs, Gs, Gs, Gs, Rp, Rp, Rp, Gs, Gd^Vhr, Gs, Gs, Gs, Gs, Gs, Gll^Fp, Gs, Gs, Gs, Gll^Fp, Gs, Gs, Gs, Gs, Gd^Vhr, Rp, Rr, Wwg^Bw\, Wwg, Rp, Gd^Vhr, Rp, Gs, Rp, Gs, Rp, Gs, Rp, Gs, Rp, Rp, Rp, Rp, Gs, Gs, Mm, Hh, Ms, Hh, Hh, Gs, Gs, Gs
Gs, Gs, Rp, Rp, Gll^Fp, Gll^Fp, Gs, Rp, Rp, Rp, Rp, Rp, Rp, Gs, Rp, Gs, Gs, Gs, Gs, Gs, Gs, Gs, Rp, Rp, Wwg, Wwg, Khr, Rp, Gs, Rp, Gs, Rp, Gll^Fp, Rp, Gs, Rp, Gs, Rp, Gs, Gd^Vhr, Gs, Gs, Gs, Gs, Gs, Aa, Aa, Aa, Aa, Gs, Gs, Gs
Rp, Rp, Gs, Gll^Fp, Gs, Gll^Fp, Gs, Gs, Gs, Gs, Gll^Fp, Gs, Gs, Rp, Gs, Rp, Rp, Rp, Rp, Rp, Rp, Rp, Gd^Vhr, Gs, Wwg, Ch, Chr, Chr, Gs, Gs, Gs, Gs, Gs, Gs, Gs, Gs, Gs, Aa, Gs, Gs, Gs, Gll^Fp, Gs, Gs, Gs, Gs, Gs, Gs, Gs, Gs, Gs, Gs
Gs, Gs, Gs, Gs, Gll^Fp, Gs, Gs, Gs, Gs, Gll^Fp, Gs, Gs, Gs, Aa, Gs, Gs, Gs, Gs, Gs, Gs, Gs, Gs, Gs, Gs, Wwg, Chr, Chr, Ch, Gs, Gs, Gs, Gs, Gs, Gs, Gs, Gs, Gs, Gs, Gs, Gs, Gs, Gs, Gs, Gs, Gs, Gs, Gs, Gs, Gs, Gs, Gs, Gs
Gs, Gs, Gs, Gll^Fp, Gs, Gs, Gs, Gs, Gs, Gs, Gs, Gs, Gs, Gs, Gs, Gs, Gs, Gs, Gs, Aa, Gs, Gs, Gs, Gs, Gs, Wwg, Wwg, Gs, Gs, Gs, Gs, Gs, Gs, Gs, Gs, Gs, Gs, Gs, Gs, Gs, Wwg, Gs, Wwg, Wwg, Wwg, Wwg, Wwg, Wwg, Wwg, Wwg, Wwg, Wwg
Wwg, Wwg, Wwg, Wwg, Wwg, Wwg, Wwg, Wwg, Wwg, Wwg, Wwg, Wwg, Wwg, Wwg, Wwg, Gs, Wwg, Gs, Wwg, Gs, Wwg, Gs, Wwg, Gs, Wwg, Gs, Wwg, Gs, Wwg, Gs, Wwg, Gs, Wwg, Gs, Wwg, Gs, Wwg, Gs, Wwg, Wwg, Wog, Wwg, Wog, Wog, Wog, Wog, Wog, Wog, Wog, Wog, Wog, Wog
Wog, Wog, Wog, Wog, Wog, Wog, Wog, Wog, Wog, Wog, Wog, Wog, Wog, Wog, Wog, Wwg, Wog, Wwg, Wog, Wwg, Wog, Wwg, Wog, Wwg, Wog, Wwg, Wog, Wwg, Wog, Wwg, Wog, Wwg, Wog, Wwg, Wog, Wwg, Wog, Wwg, Wog, Wog, Wog, Wog, Wog, Wog, Wog, Wog, Wog, Wog, Wog, Wog, Wog, Wog
Wog, Wog, Wog, Wog, Wog, Wog, Wog, Wog, Wog, Wog, Wog, Wog, Wog, Wog, Wog, Wog, Wog, Wog, Wog, Wog, Wog, Wog, Wog, Wog, Wog, Wog, Wog, Wog, Wog, Wog, Wog, Wog, Wog, Wog, Wog, Wog, Wog, Wog, Wog, Wog, Wog, Wog, Wog, Wog, Wog, Wog, Wog, Wog, Wog, Wog, Wog, Wog
Wog, Wog, Wog, Wog, Wog, Wog, Wog, Wog, Wog, Wog, Wog, Wog, Wog, Wog, Wog, Wog, Wog, Wog, Wog, Wog, Wog, Wog, Wog, Wog, Wog, Wog, Wog, Wog, Wog, Wog, Wog, Wog, Wog, Wog, Wog, Wog, Wog, Wog, Wog, Wog, Wog, Wog, Wog, Wog, Wog, Wog, Wog, Wog, Wog, Wog, Wog, Wog
