Gs, Gs, Gs, Gs, Gll^Fp, Gs, Gs, Hh, Gs, Gs, Rr, Gs, Gs, Hh, Gs, Gs, Gs, Gs, Gs, Gs, Gs, Gs, Gs, Gll^Fp, Gll^Fp, Gs, Gll^Fp, Gs, Gs, Gs, Gs, Gs, Rr, Rr, Gs, Gs, Gs, Gs
Gs, Gs, Gs, Gs, Gs, Gs, Gs, Gs, Gs, Gs, Rr, Gs, Aa, Gs, Gs, Aa, Gs, Gs, Aa, Gll^Fp, Hh, Hh, Gs, Gs, Gs, Gll^Fp, Gs, Gs, Gs, Gs, Rr, Rr, Ke, Ce, Gs, Gll^Fp, Gs, Gs
Gs, Gs, Gs, Aa, Gs, Gs, Gs, Gll^Fp, Gs, Gs, Rr, Gs, Gs, Gs, Gs, Gs, Gs, Gs, Gs, Gs, Gs, Gs, Gll^Fp, Gs, Gs, Gs, Gs, Gs, Rr, Rr, Hh, Ce, Ce, Ce, Gs, Gll^Fp, Gs, Gs
Gs, Gs, Gs, Gs, Gs, Gs, Gll^Fp, Gs, Gs, Gs, Rr, Gd^Vhr, Gs, Gs, Hh, Hh, Gs, Gll^Fp, Gs, Gs, Gs, Gs, Gs, Gs, Gs, Aa, Rr, Rr, Gs, Gd^Vhr, Gs, Ce, Ce, Ce, Gs, Gs, Gs, Gs
Gs, Gll^Fp, Gs, Gs, Gs, Gll^Fp, Gs, Gs, Gs, Gs, Rr, Gs, Gs, Gs, Gs, Gs, Gs, Gs, Gs, Hh, Gs, Gs, Gs, Gs, Gs, Gs, Rr, Gs, Gs, Gs, Gs, Gs, Gs, Gs, Hh, Gs, Gs, Gs
Gs, Gs, Gs, Hh, Gs, Gs, Gs, Aa, Gs, Gs, Rr, Gs, Aa, Gs, Gs, Gs, Gs, Gs, Aa, Gs, Gs, Gs, Gs, Gs, Gs, Gs, Rr, Gs, Gs, Gs, Gs, Gll^Fp, Gs, Gs, Aa, Gs, Gs, Gs
Gs, Gs, Gs, Gs, Gs, Gs, Gs, Gs, Gs, Gs, Rr, Gs, Gs, Gs, Gs, Gs, Gs, Gs, Gs, Gs, Gs, Gs, Gs, Gll^Fp, Gs, Gs, Rr, Gs, Gs, Gs, Gs, Gll^Fp, Gs, Gs, Gs, Hh, Gs, Gs
Gs, Gs, Gs, Gs, Gs, Gs, Gll^Fp, Gs, Gs, Gs, Rr, Gs, Gs, Gs, Gs, Gll^Fp, Gs, Gll^Fp, Gs, Gs, Gs, Gs, Gs, Gs, Gs, Gll^Fp, Rr, Gs, Gs, Gs, Gs, Gs, Gll^Fp, Gs, Gs, Hh, Gs, Gs
Rr, Gs, Gs, Gs, Gs, Gs, Rb, Gs, Gs, Gs, Rr, Gs, Gs, Gs, Gs, Gs, Gs, Gs, Ce, Ce, Ce, Gs, Gs, Gs, Gs, Gs, Rr, Gs, Gs, Gs, Gs, Gs, Gll^Fp, Gll^Fp, Gs, Gs, Gs, Gs
Gs, Rr, Rr, Gll^Fp, Rb, Rb, Rb^Gvs, Rb, Rb, Gs, Rr, Gs, Gs, Gs, Rb, Gd^Vhr, Rb^Gvs, Ce, Ce, Ket, Ce, Gs, Gs, Gs, Gs, Gs, Rrc, Gs, Gs, Gs, Gs, Gs, Gs, Gll^Fp, Gs, Gs, Gs, Gs
Gs, Gs, Rr, Rb, Rb^Gvs, Rb^Gvs, Rb^Wm, Rb^Gvs, Rb^Gvs, Rb, Rr, Gs, Rb, Rb, Rb^Gvs, Rb^Gvs, Rb^Gvs, Rb^Gvs, Ce, Ce, Ce, Gs, Gd^Vhr, Gs, Rrc, Rrc, Aa, Rrc, Rrc, Gs, Gs, Gs, Gs, Gs, Aa, Gs, Gs, Gs
Gs, Aa, Rr, Gd^Vhr, Rb, Rb^Gvs, Rb^Gvs, Rb^Gvs, Rb^Gvs, Rb^Gvs, Rrc, Rb, Rb^Gvs, Rb^Gvs, Rb^Gvs, Rb^Gvs, Rb^Wm, Rb^Gvs, Rb^Gvs, Rb^Gvs, Rb^Gvs, Gs, Rrc, Rrc, Gs, Gs, Gs, Gs, Gs, Rrc, Rrc, Hh, Gs, Gs, Gs, Gs, Gs, Gs
Gs, Gs, Rr, Gs, Gs, Rb, Ch, Ch, Rr^Dr, Chr, Rrc, Chr, Rr^Dr, Rb^Gvs, Rb^Gvs, Rb^Gvs, Rb^Gvs, Rb^Gvs, Rb^Gvs, Rb^Gvs, Rrc, Rrc, Gs, Gs, Gs, Gs, Gs, Gs, Gs, Gs, Hhd^Vhhr, Rrc, Rrc, Gs, Gs, Gs, Gs, Gs
Gs, Gs, Rr, Gs, Ch, Ch, Rrc, Rrc, Rrc, Rrc, Rr^Vhc, Rrc, Rrc, Rr, Ch, Rb^Gvs, Rb^Gvs, Rb^Gvs, Rrc, Rrc, Gs, Gs, Gs, Gs, Hh, Gs, Gs, Gs, Gs, Gs, Gs, Hh, Gs, Rrc, Rrc, Gs, Gs, Aa
Gs, Gs, Gs, Rrc, Rrc, Rrc, Gll^Fp, Rr^Vhc, Rrc, Gg, Gll^Fp, Gg, Ch, Rrc, Rrc, Rr^Dr, Rrc, Rrc, Gs, Gs, Gs, Gs, Gs, Gs, Gs, Gs, Gs, Gs, Gll^Fp, Gs, Gs, Gs, Gs, Gs, Gs, Rrc, Rrc, Gs
Gs, Gs, Gs, Ch, Rrc, Rr^Vhc, Rrc, Rrc, Rr^Vhc, Gll^Fp, Gll^Fp, Ch, Rr^Vhc, Ch, Ch, Rrc, Rr^Dr, Gs, Gs, Gs, Mm, Mm, Mm, Gs, Gs, Gs, Gs, Gs, Gs, Gs, Gs, Gs, Gs, Gll^Fp, Gs, Gs, Gs, Rrc
Gs, Gs, Gs, Ch, Ch, Rrc, Kha, Rrc, Rrc, Rr^Vhc, Rrc, Rrc, Rrc, Kh, Ch, Rrc, Chr, Gs, Gs, Gs, Mm, Mm, Mm, Mm, Mm, Gs, Gll^Fp, Gs, Gs, Gs, Gs, Gs, Gs, Gs, Gs, Gs, Gs, Gs
Gs, Gs, Gs, Gs, Ch, Rrc, Rrc, Rr, Gll^Fp, Rrc, Rrc, Ch, Ch, Ch, Rrc, Rrc, Ch, Gs, Gs, Aa, Mm, Mm, Mm, Mm, Mm, Mm, Mm, Gs, Gs, Gs, Gs, Gs, Gs, Hh, Gs, Gs, Gs, Gs
Gs, Hh, Gs, Gs, Gs, Ch, Ch, Rrc, Rrc, Rr^Vhc, Rrc, Rr^Vhc, Rrc, Rrc, Ch, Ch, Gs, Gs, Gs, Gs, Mm, Mm, Mm, Mm, Mm, Mm, Mm, Gs, Gs, Gs, Gs, Gs, Gll^Fp, Gs, Aa, Gs, Gs, Gs
Mm, Hh^Vhh, Gs, Aa, Gs, Gs, Gs, Ch, Ch, Rrc, Rr^Vhc, Rrc, Ch, Ch, Gs, Gs, Gs, Gs, Mm, Mm, Mm, Mm, Mm, Mm, Mm, Mm, Mm, Hh, Hhd^Vhhr, Gs, Gs, Gs, Gs, Gs, Gs, Gll^Fp, Gs, Gs
Mm, Mm, Mm, Gs, Hh, Gs, Gs, Gs, Gs, Ch, Ch, Ch, Gs, Gs, Gs, Gs, Hh^Vhh, Mm, Mm, Mm, Mm, Mm, Mm, Mm, Mm, Mm, Mm, Mm, Mm, Hh, Gs, Gs, Gs, Gs, Gs, Gs, Gs, Gs
Mm, Mm, Mm, Mm, Gs, Gs, Gs, Gs, Gs, Gs, Gs, Gs, Gs, Gs, Mm, Mm, Mm, Mm, Mm, Mm, Mm, Mm, Gs, Mm, Mm, Mm, Mm, Mm, Gs, Mm, Mm, Mm, Mm, Mm, Gs, Gs, Gs, Gs
