Gll^Fp, Gs, Gs, Rr, Gs, Gs, Gll^Fp, Gs, Gs, Gs, Gll^Fp, Gs, Gs, Gs, Gs, Hh, Gs, Gs, Gs, Gs, Gs, Gs, Gs, Gs, Gs, Gs, Gs, Gs, Gll^Fp, Gs, Gs, Gs, Gs, Gs, Gll^Fp, Gs, Gs, Gs, Gs, Gs, Gs, Gs, Gs, Gs, Gs, Gs, Gs, Gs, Gs, Gs, Gs, Gs, Gs, Gs, Gs, Gs, Gs, Gs, Rr, Rr
Gll^Fp, Gs, Gs, Rr, Rr, Gs, Gs, Gs, Gs, Gs, Gs, Gll^Fp, Gll^Fp, Gs, Gs, Gs, Gll^Fp, Gs, Gs, Aa, Gll^Fp, Gs, Gll^Fp, Gll^Fp, Gs, Gs, Gs, Gs, Gll^Fp, Gll^Fp, Gll^Fp, Gs, Gs, Gs, Gs, Gll^Fp, Gs, Gs, Gs, Gll^Fp, Gll^Fp, Gs, Gs, Gs, Gll^Fp, Gs, Gll^Fp, Gs, Gs, Gs, Gs, Hh, Gs, Gs, Gs, Gs, Rr, Rr, Gs, Hh
Gs, Gs, Gs, Gs, Gs, Rr, Rr, Gs, Gs, Gll^Fp, Gs, Gs, Gs, Gs, Gs, Gll^Fp, Gs, Gll^Fp, Gs, Gs, Gll^Fp, Gs, Gs, Gll^Fp, Gs, Gs^Vl, Gs, Gs, Gs, Gs, Gs, Gll^Fp, Gs, Aa, Gs, Gs, Gs, Gll^Fp, Gs, Gs, Gs, Gs, Gs, Gs, Gll^Fp, Gll^Fp, Gs, Gs, Gs, Gs, Gs, Gs, Gs, Gs, Rr, Rr, Ce, Gs, Gs, Gs
Gs, Gs, Gs, Gs, Aa, Gs, Gs, Rr, Rr, Gs, Gs, Gll^Fp, Gs, Gs, Gs, Gs, Gs, Gll^Fp, Gs, Gll^Fp, Gs, Gs, Gs, Gs, Gll^Fp, Gll^Fp, Gs, Gll^Fp, Gs, Gs, Gs, Gs, Gs, Gs, Gs, Gs, Gll^Fp, Gll^Fp, Gll^Fp, Gs, Gs, Gs, Gs, Gs, Gs, Gs, Aa, Gs, Gs, Gs, Gs, Gs, Rr, Rr, Ce, Ke, Ce, Gs, Gs, Gs
Gs, Gs, Gs, Gs, Gs, Aa, Gs, Gs, Rr, Gs, Gs, Gs, Gs, Gs, Gll^Fp, Gs, Gs, Gs, Gll^Fp, Gs, Gs, Gs, Gll^Fp, Gs, Gs, Gs, Gs, Gs, Gs, Gs, Gs, Gll^Fp, Gs, Gs, Gll^Fp, Gs, Gs, Gs, Gs, Gs, Gs, Gs, Gs, Gs, Gs, Aa, Gs, Gs, Gs, Gs, Rr, Rr, Gd^Vhr, Hh, Ce, Ce, Ce, Gs, Gs, Gs
Gs, Gs, Gll^Fp, Gs, Gs, Gs, Gs, Gs, Gs, Rr, Gs, Gs, Gs, Gs, Gs, Gs, Gll^Fp, Gs, Gs, Gs, Gs, Gs, Gs, Gll^Fp, Gs, Gs, Gs, Gs, Gs, Gs, Gs, Gs, Gs, Gs, Gll^Fp, Gs, Gs, Gs, Gs, Gs, Gd^Vhr, Gs, Gs, Gll^Fp, Gs, Gs, Gs, Gs, Rr, Rr, Gs, Gs, Gs, Gs, Gs, Ce, Gs, Gs, Gs, Gs
Gs, Gs, Gs, Gs, Aa, Gs, Gs, Gs, Gs, Rr, Gs, Gs, Gs, Gs, Gs, Gs, Gs, Gs, Gs, Gs, Gs, Gs, Gs, Gs, Gs, Gs, Gs, Gll^Fp, Gll^Fp, Gll^Fp, Gs, Gs, Gs, Gs, Gs, Gs, Gs, Gll^Fp, Gll^Fp, Gs, Gs, Gs, Gs, Gs, Gs, Gs, Rr, Rr, Gs, Gs, Gs, Gs, Gs, Gs, Gs, Gs, Gs, Gs, Gs, Gs
Gs, Gs, Gs, Gs, Gs, Gs, Gs, Gs, Gs, Rr, Gs, Gs, Gll^Fp, Gs, Gs, Gs, Aa, Gs, Gs, Gs, Gs, Gs, Hh, Hh, Hh, Hh, Gs, Gs, Gs, Aa, Gs, Gll^Fp, Gs, Gs, Gs, Gs, Gs, Gs, Gs, Gs, Gs, Gs, Gs, Gs, Rr, Rr, Gs, Gs, Gs, Gs, Gs, Gs, Gs, Gs, Gs, Gs, Gs, Gs, Gs, Gs
Gs, Gs, Gs, Gs, Gs, Gs, Gs, Gs, Gs, Rr, Gs, Gs, Gs, Gs, Gs, Gs, Gs, Gs, Gs, Gll^Fp, Gs, Gs, Hh, Hh, Gs, Gs, Gs, Gs, Gs, Gs, Gs, Gs, Gs, Gs, Gll^Fp, Gs, Gs, Gs, Gs, Gs, Gs, Gs, Rr, Rr, Gs, Gs, Gs, Gs, Gs, Gs, Gs, Gs, Gll^Fp, Gs, Gs, Gs, Gs, Gs, Gs, Gs
Gs, Gs, Gs, Gs, Gs, Gs, Gs, Gll^Fp, Gs, Rr, Gs, Gs, Gs, Gs, Gs, Gs, Gll^Fp, Gs, Gs, Gs, Gs, Gs, Gs, Gs, Gs, Gs, Gs, Gs, Gs, Gs, Gs, Gs, Gs, Gs, Gs, Gs, Gs, Gs, Gs, Gs, Gs, Gs, Rr, Gs^Dr, Gs, Gs, Gs, Gs, Gs, Gs, Gs, Gll^Fp, Gs, Gs, Gs, Gs, Gs, Gs, Gs, Gs
Gs, Gs, Gs, Gll^Fp, Gs, Gs, Gs, Gs, Gs, Rr, Rr, Gs, Gs, Gll^Fp, Gs, Gs, Gs, Gs, Gs, Gs, Gs, Gs, Gll^Fp, Gs, Gs, Gs, Gll^Fp, Gs, Gs, Gs, Gs, Gs, Gs, Gll^Fp, Gs, Gs, Gs, Aa, Gs, Gs, Rr, Rr, Gs, Gs, Gs, Gs, Gll^Fp, Gs, Gs, Gs, Gll^Fp, Gs, Gs, Gs, Gs, Gs, Gll^Fp, Gs, Gs, Gs
Gs, Gs, Gs, Gs, Gs, Gs, Gs, Gs, Gs, Gs, Rr, Gs^Vhr, Gs, Gs, Gs, Gs, Gs, Gs, Gs, Gs, Gs, Gs, Gll^Fp, Gs, Gs, Gs, Gs, Gs, Gll^Fp, Gs, Gs, Gs, Gs, Gs, Gll^Fp, Gs, Gs, Gs, Gs, Gs, Rr, Gs, Gs, Gs, Gs, Gs, Gs, Gll^Fp, Gs, Gs, Gs, Gs, Gs, Gs, Gs, Gs, Gs, Gs, Gs, Gs
Gs, Gs, Gs, Gs, Gs, Gs, Gs, Gs, Aa, Gs, Gs, Rr, Rr, Gs, Gs, Gs, Gs, Gs, Gs, Gs, Gs, Gs, Gs, Gs, Gs, Gs, Gs, Gs, Gs, Gs, Gs, Gs, Gs, Gs, Gs, Gs, Gs, Gs, Gs, Rr, Gs, Gs, Gs, Gs, Gs, Gs, Gs, Gs, Gs, Gs, Gs, Gs, Gs, Gs, Gs, Gs, Gs, Gs, Gs, Gs
Gs, Gs, Gs, Gs, Gs, Gs, Gs, Gs, Gs, Gs, Gs, Gs, Rr, Gs, Gs, Gs, Gs, Gs, Gs, Gll^Fp, Gs, Gs, Ce, Ce, Ce, Gs, Gs, Gs, Gs, Gs, Gs, Gll^Fp, Gs, Gs, Gs, Gs, Gs, Gs, Rr, Rr, Gs, Gs, Gs, Gs, Gll^Fp, Gll^Fp, Gs, Gs, Gs, Gs, Aa, Gs, Gs, Gs, Gs, Gs, Gs, Gs, Gs, Gs
Gs, Gs, Gs, Gs, Gs, Gs, Gs, Gs, Gs, Gs, Gs, Gs, Rr, Gs, Gs, Gs, Gs, Gs, Gs, Gs, Gs, Ce, Ce, Ket, Ce, Gs^Vct, Gs, Gs, Gs, Gs, Gs, Gs, Gs, Gs, Gs, Gs, Gs, Gs^Dr, Rr, Gs, Gs, Gs, Gs, Gs, Gs, Gll^Fp, Gs, Gs, Gs, Gs, Gs, Gs, Gs, Gs, Gs, Gs, Gs, Gs, Gs, Gs
Gs, Gs, Gs, Gs, Gs, Gs, Gll^Fp, Gs, Gs, Gs, Gs, Gs, Rr, Gs, Gs, Gll^Fp, Gs, Gs, Gs, Gs, Gs, Re^Vct, Ce, Ce, Ce, Gs, Gll^Fp, Gs, Gs, Gs, Gs, Gs, Gs, Gs, Gs, Gs, Rr, Rr, Gs, Gs, Gs, Gs, Gs, Gs, Gll^Fp, Gs, Gs, Gs, Gs, Gs, Gs, Gs, Gs, Gll^Fp, Gs, Gs, Gs, Gs, Gs, Gs
Gs, Gs, Gs, Gs, Gs, Gs, Gs, Gs, Gs, Hh, Gs, Gs, Rr, Gs, Gs, Hh, Gs, Gs, Gs, Gs, Gs, Gs, Ce, Ce, Gs, Gs, Gs, Gs, Gs, Gs, Gs, Gs, Gs, Gs, Rr, Rr, Gs, Gs, Gs, Gs, Gs, Gs, Gs, Gll^Fp, Gs, Gs, Gs, Gs, Gs, Gs, Gs, Gs, Gs, Gs, Gs, Gs, Gs, Gs, Gs, Gs
Gs, Gs, Gs, Gs, Gs, Gs, Gs, Gs, Gs, Gs, Gs, Gs, Rr, Gs, Aa, Aa, Gs, Gs, Gs, Gs, Aa, Gll^Fp, Hh, Hh, Gs, Gs, Gs, Gll^Fp, Gs, Gs, Gs, Gs, Rr, Rr, Gs, Gs, Gs, Gll^Fp, Gs, Gs, Gs, Gs, Gs, Gs, Gs, Gs, Gs, Gs, Gs, Gs, Gs, Gs, Hh, Gs, Gs, Gs, Gs, Gs, Gs, Gs
Gs, Gs, Gs, Gs, Gs, Aa, Gs, Gs, Gs, Gs, Gs, Gs, Rr, Gs, Gs, Gs, Gs, Gs, Gs, Gs, Gs, Gs, Gs, Gs, Gll^Fp, Gs, Gs, Gs, Gs, Gs, Rr, Rr, Gs, Gs, Gs, Gs, Gs, Gll^Fp, Gs, Gs, Gs, Gs, Gs, Gs, Gs, Aa, Gs, Gs, Gs, Gll^Fp, Gll^Fp, Gs, Gs, Gs, Gs, Gs, Gs, Gs, Gs, Gs
Gs, Gs, Gs, Gs, Gs, Gs, Gs, Gs, Gs, Gll^Fp, Gs, Gs, Rr, Gd^Vhr, Gs, Gs, Hh, Hh, Gs, Gll^Fp, Gs, Gs, Gs, Gs, Gs, Gs, Gs, Aa, Rr, Rr, Gs, Gs, Gs, Gs, Gs, Gs, Gs, Gs, Gs, Gs, Gs, Gs, Gs, Gs, Gs, Gs, Gs, Gs, Gs, Gs, Gs, Gs, Gs, Gs, Gs, Gs, Gs, Gs, Gs, Gs
Gs, Gs, Gs, Gll^Fp, Gs, Gs, Gs, Gs, Gs, Gs, Gs, Gs, Rr, Gs, Gs, Gs, Gs, Gs, Gs, Gs, Gs, Hh, Gs, Gs, Gs, Gs, Gs, Gs, Rr, Gd^Vhr, Gs, Gs, Gs, Gs, Gs, Gs, Hh, Gs, Gs, Gs, Gs, Hh, Hh, Gs, Gs, Gs, Gs, Gs, Gs, Gs, Gs, Gs, Gs, Gs, Gll^Fp, Gs, Gs, Gs, Gs, Gs
Gs, Gs, Gs, Gs, Gs, Hh, Gs, Gs, Gs, Gs, Gs, Gs, Rr, Chr, Aa, Gs, Gs, Gs, Gs, Gs, Gs, Gs, Gs, Gs, Gs, Gs, Gs, Gs, Rr, Gs, Gs, Gs, Gs, Gll^Fp, Gs, Gs, Aa, Gs, Gs, Gs, Gs, Gs, Gs, Gs, Gs, Gs, Gs, Gs, Hh, Gs, Gs, Gs, Gs, Gs, Gs, Gs, Gs, Gs, Gs, Gs
Gs, Gs, Gs, Gs, Gs, Gs, Gs, Gs, Gs, Gs, Gs, Gs, Rr, Gs, Gs, Gs, Gs, Gs, Gs, Gs, Gs, Gs, Gs, Gs, Gs, Gll^Fp, Gs, Gs, Rr, Gs, Gs, Gs, Gs, Gll^Fp, Gs, Gs, Gs, Hh, Gs, Gs, Gs, Gs, Gs, Gs, Gs, Gs, Gs, Gs, Hh, Hh, Gs, Gs, Gs, Gs, Gs, Gs, Gs, Gs, Gs, Gs
Gs, Gs, Gs, Gs, Gs, Gs, Gs, Gs, Gs, Gs, Gs, Gs, Rr, Gs, Gs, Gs, Gs, Gll^Fp, Gs, Gll^Fp, Rb, Rb, Rb, Gs, Gs, Gs, Gs, Gll^Fp, Rr, Gs, Gs, Gs, Gs, Gs, Gs, Gs, Gs, Hh, Gs, Gs, Gs, Gs, Gs, Gs, Gll^Fp, Gll^Fp, Gs, Gs, Hh, Gs, Gs, Gs, Gs, Gs, Gs, Gs, Gs, Gs, Gs, Gs
Rr, Rr, Rr, Gs, Gs, Gs, Gs, Gs, Rb, Gs, Gs, Gs, Rr, Gs, Gs, Gs, Gs, Gs, Rb, Rb, Rb^Gvs, Rb^Gvs, Rb^Gvs, Rb, Rb, Gs, Gs, Gs, Rr, Gs, Gs, Gs, Gs, Gs, Gll^Fp, Gll^Fp, Gs, Gs, Gs, Gs, Gs, Gs, Gs, Gs, Gs, Gs, Gs, Gs, Gs, Gs, Gs, Gs, Gs, Gs, Gs, Gs, Gs, Gs, Gs, Gs
Gs, Chr, Gs, Rr, Rr, Gll^Fp, Rb, Rb, Rb^Gvs, Rb, Rb, Gs, Rr, Gs, Gs, Gs, Rb, Rb, Rb^Gvs, Rb^Gvs, Rb^Gvs, Rb^Gvs, Rb^Gvs, Rb^Gvs, Rb^Gvs, Rb, Rb, Gd^Vhr, Rrc, Chr, Gs, Gs, Gs, Gs, Gs, Gll^Fp, Gs, Gs, Gs, Gs, Gs, Gs, Gs, Gs, Gs, Gs, Gs, Gs, Gs, Gs, Gs, Gll^Fp, Gs, Gs, Gs, Gs, Gs, Gll^Fp, Gs, Gs
Gs, Gs, Gs, Gs, Rr, Rb, Rb^Gvs, Rb^Gvs, Rb^Wm, Rb^Gvs, Rb^Gvs, Rb, Rr, Gs, Rb, Rb, Rb^Gvs, Rb^Gvs, Rb^Gvs, Rb^Gvs, Rb^Gvs, Rb^Gvs, Rb^Gvs, Rb^Gvs, Rb^Gvs, Rb^Gvs, Rrc, Rrc, Aa, Rrc, Rrc, Gs, Gs, Gs, Gs, Gs, Gs, Gs, Gs, Gs, Gs, Gs, Gs, Gs, Gll^Fp, Gs, Gs, Gs, Gs, Gs, Gs, Gs, Gs, Gs, Gs, Gs, Gs, Gs, Gs, Gs
Gs, Gs, Gs, Aa, Rr, Gd^Vhr, Rb, Rb^Gvs, Rb^Gvs, Rb^Gvs, Rb^Gvs, Rb^Gvs, Rrc, Rb, Rb^Gvs, Rb^Gvs, Rb^Gvs, Rb^Gvs, Rb^Wm, Rb^Gvs, Rb^Gvs, Rb^Gvs, Rb^Gvs, Rb^Gvs, Rrc, Rrc, Gs, Gs, Gs, Gs, Gs, Rrc, Rrc, Hh, Gs, Gs, Gs, Gs, Gs, Hh, Hh, Gs, Gs, Gs, Gs, Gll^Fp, Gs, Gs, Gs, Gs, Gs, Gs, Gs, Gs, Gs, Gs, Gs, Gs, Gs, Gs
Gs, Gs, Gs, Gs, Rr, Gs, Gs, Rb, Ch, Ch, Rr^Dr, Chr, Rrc, Chr, Rr^Dr, Rb^Gvs, Rb^Gvs, Rb^Gvs, Rb^Gvs, Rb^Gvs, Rb^Gvs, Rb^Vhr, Rrc, Rrc, Gs, Gs, Gs, Gs, Gs, Gs, Gs, Gs, Hhd^Vhhr, Rrc, Rrc, Gs, Gs, Aa, Gs, Gs, Hh, Gs, Gs, Gs, Gs, Gs, Hh, Gs, Gs, Gs, Gs, Gs, Gll^Fp, Gs, Gs, Gs, Gs, Gs, Gs, Gs
Gs, Gs, Gs, Gs, Rr, Gs, Ch, Ch, Rrc, Rrc, Rrc, Rrc, Rr^Vhc, Rrc, Rrc, Rr, Ch, Rb^Gvs, Rb^Gvs, Rb^Gvs, Rrc, Rrc, Gs, Gs, Gs, Gs, Hh, Gs, Mm, Gs, Gs, Gs, Gs, Hh, Gs, Rrc, Rrc, Gs, Gs, Gs, Gs, Gs, Gs, Gs, Gs, Gs, Gs, Hh, Gs, Gs, Gs, Gs, Gs, Gs, Gs, Gll^Fp, Gll^Fp, Gs, Gs, Gs
Gs, Gs, Gs, Gs, Gs, Rrc, Rrc, Rrc, Gll^Fp, Rr^Vhc, Rrc, Gg, Gll^Fp, Gg, Ch, Rrc, Rrc, Rr^Dr, Rrc, Rrc, Gs, Gs, Hh, Gs, Mm, Mm, Mm, Mm, Mm, Mm, Gll^Fp, Mm, Mm, Gs, Gs, Gs, Gs, Rrc, Rrc, Gs, Gs, Gs, Gs, Gs, Gs, Gs, Gs, Gs, Gs, Gs, Gs, Gs, Gll^Fp, Gs, Gs, Gs, Gs, Gs, Gs, Gs
Gs, Gs, Gs, Gs, Gs, Ch, Rrc, Rr^Vhc, Rrc, Rrc, Rr^Vhc, Gll^Fp, Gll^Fp, Ch, Rr^Vhc, Ch, Ch, Rrc, Rr^Dr, Gs, Gs, Hh, Mm, Mm, Mm, Mm, Mm, Mm, Mm, Mm, Mm, Mm, Mm, Mm, Gs, Gll^Fp, Gs, Gs, Gs, Rrc, Rrc, Gs, Gs, Gs, Gs, Gs, Gs, Gs, Gs, Gs, Gs, Gs, Gs, Gll^Fp, Gs, Gs, Gs, Gs, Gs, Gs
Mm, Gs, Gs, Gs, Gs, Ch, Ch, Rrc, Kha, Rrc, Rrc, Rr^Vhc, Rrc, Rrc, Rrc, Kh, Ch, Rrc, Chr, Gs, Gs, Hh, Mm, Mm, Mm, Mm, Mm, Mm, Gll^Fp, Mm, Mm, Mm, Mm, Mm, Gs, Gs, Gs, Gs, Gs, Gs, Gs, Rrc, Rrc, Gs, Rrc, Gs, Gs, Gs, Gs, Gll^Fp, Gs, Gs, Gs, Gs, Gs, Gs, Gll^Fp, Gs, Gs, Gs
Mm, Gs, Gs, Gs, Gs, Gs, Ch, Rrc, Rrc, Rr, Gll^Fp, Rrc, Rrc, Ch, Ch, Ch, Rrc, Rrc, Ch, Gs, Gs, Aa, Mm, Mm, Mm, Mm, Mm, Mm, Mm, Mm, Mm, Mm, Mm, Mm, Gs, Hh, Gs, Gs, Gs, Gs, Gs, Gs, Gs, Rrc, Gs, Rrc, Rrc, Rrc, Rrc, Gs, Gs, Gs, Gs, Gs, Gs, Gll^Fp, Gs, Gs, Gll^Fp, Gs
Mm, Mm, Mm, Hh, Gs, Gs, Gs, Ch, Ch, Rrc, Rrc, Rr^Vhc, Rrc, Rr^Vhc, Rrc, Rrc, Ch, Ch, Gs, Gs, Gs, Hh, Mm, Mm, Mm, Mm, Mm, Mm, Mm, Mm, Mm, Mm, Gs, Gs, Gll^Fp, Gs, Aa, Gs, Gs, Gs, Gs, Gs, Gs, Gs, Hh, Hh, Hh, Gs, Gs, Rrc, Rrc, Gs, Gs, Gs, Gs, Gll^Fp, Gs, Gs, Gs, Gll^Fp
Mm, Mm, Mm, Hh^Vhh, Gs, Aa, Gs, Gs, Gs, Ch, Ch, Rrc, Rr^Vhc, Rrc, Ch, Ch, Gs, Gs, Gs, Gs, Mm, Mm, Mm, Mm, Mm, Mm, Mm, Mm, Mm, Hh, Hh^Vhh, Gs, Gs, Gs, Gs, Gs, Gs, Gll^Fp, Gs, Gs, Gs, Gs, Mm, Mm, Mm, Hh, Hh, Hh, Hh, Gs, Rrc, Ch, Gs, Gs, Gs, Gll^Fp, Gs, Gs, Gs, Gs
Mm, Mm, Mm, Mm, Mm, Gs, Hh, Gs, Gs, Gs, Gs, Ch, Ch, Ch, Gs, Gs, Gs, Gs, Hh^Vhh, Mm, Mm, Mm, Mm, Mm, Mm, Mm, Mm, Mm, Mm, Mm, Mm, Hh, Gs, Gs, Gs, Gs, Gs, Gs, Gs, Gs, Gs, Gs, Mm, Mm, Mm, Mm, Mm, Hh, Hh, Gs, Gs, Rrc, Gs, Gs, Hh, Gs, Gs, Gs, Gs, Gs
Mm, Mm, Mm, Mm, Mm, Mm, Mm, Gs, Gs, Gs, Gs, Gs, Gs, Gs, Gs, Gs, Mm, Mm, Mm, Mm, Mm, Mm, Mm, Mm, Mm, Mm, Mm, Mm, Mm, Mm, Mm, Mm, Mm, Mm, Mm, Mm, Gs, Gs, Gs, Gs, Mm, Mm, Mm, Mm, Mm, Mm, Mm, Mm, Mm, Gs, Gs, Rrc, Rrc, Gs, Gs, Gs, Gll^Fp, Gs, Gs, Gs
Mm, Mm, Mm, Mm, Mm, Mm, Mm, Mm, Mm, Mm, Mm, Gs, Mm, Gs, Hh, Hh, Mm, Mm, Mm, Mm, Mm, Mm, Mm, Mm, Mm, Mm, Mm, Mm, Mm, Mm, Mm, Mm, Mm, Mm, Mm, Mm, Gs, Gs, Gs, Gs, Gs, Mm, Mm, Mm, Gs, Mm, Gs, Mm, Gs, Gs, Gs, Gs, Rrc, Gs, Gs, Gs, Gs, Gs, Gs, Gs
Mm, Mm, Mm, Mm, Mm, Mm, Gs, Mm, Mm, Mm, Mm, Mm, Mm, Mm, Mm, Mm, Mm, Mm, Mm, Mm, Mm, Mm, Mm, Mm, Mm, Mm, Mm, Mm, Mm, Mm, Mm, Mm, Mm, Mm, Mm, Mm, Gs, Gs, Gs, Gs, Gs, Gs, Mm, Mm, Mm, Gs, Gs, Gs, Gs, Gs, Gs, Gs, Rrc, Gs, Gs, Gs, Gs, Gs, Gs, Gs
