Rr, Gs, Gs, Gs, Gs, Gs, Gs, Gs, Gs, Gs, Gs, Gs, Gs, Gs, Gs, Gs, Gs, Gs, Gs, Gs, Gs, Gs, Gs, Gs, Gs, Gs, Gs, Wwg, Gs, Gs, Gs, Gs, Gs, Gs, Gs, Gs, Gs, Gs, Gs, Gs, Gs, Gs, Gll^Fp, Gs, Gs, Gs, Gs, Gs, Gs, Gs, Gs, Gs, Gs, Gs
Gs, Gs, Gs, Aa^Fpa, Gs, Gs, Gs, Gs, Aa^Fpa, Gs, Gs, Gs, Gll^Fp, Gs, Gll^Fp, Gs, Gs, Gs, Gs, Gs, Gs, Gs, Gs, Gs, Gs, Gs, Gs, Wwg, Wwg, Gs, Gs, Gs, Gs, Gs, Gs, Gs, Gs, Gs, Gs, Gs, Gs, Gs, Gll^Fp, Gs, Gs, Gs, Gs, Gs, Gs, Gs, Aa, Gs, Gs, Gs
Gs, Gs, Gs, Gs, Gs, Gs, Gll^Fp, Gs, Gs, Gs, Gs, Gll^Fp, Gs, Gs, Gs, Gs, Gs, Aa^Fma, Aa^Fma, Gs, Gs, Gs, Gs, Gs, Gs, Gs, Gs, Gs, Wwg, Gs, Gs, Gs, Gll^Fp, Gs, Gs, Gs, Gs, Gs, Gs, Gll^Fp, Gs, Gs, Gs, Gs, Aa^Fma, Gs, Gs, Gs^Vhr, Gs, Aa, Gs, Aa, Gs, Gs
Gs, Gs, Gs, Gs, Gs, Gs, Gll^Fp, Gs, Gs, Gll^Fp, Aa^Fpa, Gs, Gs, Gll^Fp, Gll^Fp, Gs, Gs, Aa^Fma, Gs, Gs, Gll^Fp, Gll^Fp, Gs, Gs, Gs, Gs, Gll^Fp, Gs, Wwg, Gs, Gs, Gs, Gll^Fp, Gs, Gs, Aa^Fpa, Gs, Gs, Gs, Gll^Fp, Gs, Gs, Gs, Aa^Fma, Gs, Gs, Gll^Fp, Gs, Gs, Gs, Gll^Fp, Gs, Ai, Wwg
Gs, Gs, Gs, Gs, Ce, Gs, Gs, Gs, Gs, Gs, Gs, Gs, Gs, Gs, Gs, Gs, Gs, Gs, Gs, Gs, Gs, Gll^Fp, Gs, Gs, Gs, Gs, Gs, Gs, Gd^Vhr, Wwg, Gs, Gs, Gs, Gs, Gs, Gs, Gll^Fp, Gs, Gs, Gs, Gs, Gs, Gs, Gs, Gs, Gs, Gs, Gll^Fp, Gs, Gs, Wwg, Wwg, Gs, Gs
Gs, Gs, Gs, Ce, Ke, Ce, Gs, Gs, Gs, Gs, Gs, Gs, Aa, Gs, Gs, Gs, Gs, Gs, Gs, Gs, Gs, Gs, Gs, Gs, Gs, Gll^Fp, Gs, Gs, Gs, Wwg, Gs, Gs, Gs, Aa, Gs, Gll^Fp, Gs, Gs, Gs, Gll^Fp, Gs, Gs, Gs, Gs, Gs, Gs, Gs, Gs, Gs, Gs, Wwg, Gll^Fp, Gs, Gs
Gs, Gs, Gs, Ce, Ce, Ce, Gs, Gs, Rp, Gs, Gs, Gs, Aa, Gs, Gs, Gs, Gs, Gs, Gs, Gll^Fp, Gs, Gs, Gs, Gs, Gs, Gs, Gll^Fp, Gs, Gs, Ai, Gs, Gs, Gs, Gs, Gs, Gs, Gll^Fp, Gs, Gs, Gs, Gs, Gs, Aa^Fpa, Gs, Gs, Gs, Gll^Fp, Gs, Wwg, Wwg, Gs, Gs, Gs, Gs
Gs, Gs, Rp, Rp, Rp, Rp, Rp, Rp, Gs, Rp, Rp, Gs, Gs, Gs, Gs, Gs, Gs, Gs, Gs, Gll^Fp, Gs, Gs, Gs, Gs, Gs, Gs, Gs, Gs, Gs, Wwg, Aa, Aa, Gs, Gs, Gs, Gll^Fp, Gs, Gs, Gs, Gs, Gs, Gs, Gs, Gs, Gs, Gll^Fp, Gs, Gs, Wwg, Gs, Gs, Gll^Fp, Gs, Gs
Gs, Rp, Gll^Fp, Gs^Vhr, Gs, Gs, Gs, Gs, Gs, Gs, Gs, Rp, Rp, Gs, Gd^Vhr, Gs, Rp, Gs, Gs, Gs, Gs, Gs, Gs, Gs, Gs, Gs, Gs, Gs, Gs, Wwg, Wwg, Gs, Gs, Gs, Gs, Gs, Gs, Gs, Gs, Gs, Gs, Gll^Fp, Gs, Gs, Gs, Gs, Wwg, Ai, Gs, Gs, Gs, Gs, Gs, Gs
Rp, Rp, Gll^Fp, Gll^Fp, Gs, Gs, Gs, Gs, Mm, Mm, Mm, Gs, Gs, Rp, Rp, Rp, Gll^Fp, Rp, Rp, Rp, Aa, Aa, Gs, Gll^Fp, Gs, Gs, Gs, Gs, Wwg, Wwg, Gs, Wwg, Wwg, Gs, Wwg, Wwg, Wwg, Gs, Gs, Gs, Aa, Gs, Gs, Gs, Wwg, Wwg, Aa^Fpa, Gs, Gs, Gs, Gs, Gs, Gs, Gs
Gs, Gs, Gs, Gll^Fp, Gs, Gs, Gs, Gll^Fp, Gs, Mm, Gs, Gs, Gs, Gll^Fp, Gll^Fp, Gs, Gs, Gs, Gs, Gs, Gs, Rp, Rp, Gll^Fp, Rp, Gs, Gs, Wwg, Gs, Gs, Hh, Hh, Gs, Wwg, Gll^Fp, Gll^Fp, Gs, Wwg, Wwg, Wwg, Wwg, Gll^Fp, Wwg, Gs, Wwg, Gs, Gs, Gs, Gs, Hh, Gs, Gs, Gs, Gs
Gs, Gs, Gs, Gs, Gs, Gs, Gs, Gs, Gs, Gs, Gs, Gs, Gs, Gs, Gs, Gs, Gs, Gll^Fp, Gll^Fp, Gs, Gs, Gs, Gs, Rp, Gs, Rp, Rp, Wwg, Gs, Gs, Gs, Gs, Gs, Gs, Gs, Gs, Gll^Fp, Gs, Ce, Ce, Ce, Wwg, Gs, Wwg, Gs, Gs, Gs, Gs, Gs, Gs, Gs, Gs, Aa^Fpa, Gs
Gs, Gs, Mm, Mm, Mm, Gs, Gs, Gs, Gs, Gll^Fp, Gs, Gs, Gs, Gs, Gs, Gs, Gs, Gs, Gs, Gs, Gs, Hh, Gs, Gs, Gs, Gs, Gs, Wwg^Bw\, Rp, Gs, Gs, Gs, Gs, Gs, Gs, Gs, Gs, Ce, Ke, Ce, Ce, Aa, Gs, Gs, Gs, Gs, Gll^Fp, Gll^Fp, Gs, Hh, Gs, Gs, Gs, Gs
Gs, Gs, Gs, Mm, Gs, Gs, Gs, Gs, Gs, Gs, Gs, Gs, Aa, Aa, Gs, Gs, Aa, Aa, Aa, Gs, Hh, Hh, Gs, Gll^Fp, Gs, Gs, Gs, Wwg, Gs, Rp, Rp, Gs, Gs, Gs, Gs, Gs, Gs, Ce, Ce, Ce, Gs, Gs, Gs, Gs, Gs, Gs, Gs, Gll^Fp, Gs, Hh, Gs, Gs, Gs, Gs
Gs, Gs, Gs, Gs, Gs, Gs, Gs, Gs, Gs, Gs, Gs, Gs, Gs, Gs, Gs, Gs, Gs, Gs, Gs, Gs, Gs, Gs, Gs, Gs, Gs, Aa^Fma, Gs, Wwg, Gs, Gs, Gs, Rp, Rp, Gs, Rp, Gs, Rp, Rp, Rp, Gs^Vct, Rp, Rp, Rp, Gs, Gs, Gs, Gs, Gs, Gs, Gs, Gs, Gs, Gs, Gs
Gs, Gs, Gs, Gs, Gs, Gs, Wwg, Gs, Wwg, Wwg, Wwg, Wwg, Wwg, Wwg, Wwg, Wwg, Wwg, Gs, Gs, Gs, Gs, Gs, Gs, Gll^Fp, Gs, Aa^Fma, Gs, Wwg, Gs, Gs, Gs, Gll^Fp, Gll^Fp, Rp, Gs, Rp, Gs, Gs, Gll^Fp, Rp, Gs, Gs, Gs, Rp, Rp, Gs, Gs, Gs, Gs, Aa^Fpa, Gs, Gs, Gll^Fp, Gs
Gs, Gs, Gs, Wog, Wog, Wog, Wog, Wog, Wog, Wog, Wog, Wog, Wog, Wog, Wog, Wog, Wog, Wwg, Wwg, Gs, Wwg, Gs, Gs, Gs, Gs, Gs, Gs, Wwg, Gs, Gll^Fp, Gs, Gs, Gll^Fp, Gs, Gs, Gs, Gs, Gs, Gs, Gll^Fp, Gs, Gs, Gs, Gs, Gs, Rp, Gs, Gs, Gs, Gs, Gs, Gs, Gll^Fp, Gs
Gs, Gs, Wog, Wog, Wog, Wog, Wog, Wog, Wog, Wog, Wog, Wog, Wog, Wog, Wog, Wog, Wog, Wog, Wog, Wwg, Wog, Wwg, Wwg, Gs, Wwg, Gs, Gs, Wwg, Wwg, Gs, Gs, Gll^Fp, Wwg, Gs, Gs, Gs, Wwg, Gs, Wwg, Gs, Gs, Gs, Gs, Gs, Gs, Rp, Gs, Gs, Gs, Gs, Gs, Gs, Gs, Gs
Wog, Wog, Wog, Wog, Wog, Wog, Wog, Wog, Wog, Wog, Wog, Wog, Wog, Wog, Wog, Wog, Wog, Wog, Wog, Wog, Wog, Wog, Wog, Wwg, Wog, Wwg, Wwg, Gs, Wwg, Gs, Wwg, Wwg, Wog, Wwg, Wwg, Wwg, Wog, Wwg, Wog, Wwg, Wwg, Gs, Gs, Gs, Gs, Rp, Gs, Gs, Gs, Gs, Gs, Gs, Gs, Gs
Wog, Wog, Wog, Wog, Wog, Wog, Wog, Wog, Wog, Wog, Wog, Wog, Wog, Wog, Wog, Wog, Wog, Wog, Wog, Wog, Wog, Wog, Wog, Wog, Wog, Wog, Wog, Wwg, Wog, Wwg, Wog, Wog, Wog, Wog, Wog, Wog, Wog, Wog, Wog, Wog, Wog, Wwg, Wwg, Gs, Gs, Rp, Gs, Gs, Gll^Fp, Gs, Gs, Gs, Gs, Gs
Wog, Wog, Wog, Wog, Wog, Wog, Wog, Wog, Wog, Ai, Wog, Wog, Wog, Wog, Wog, Wog, Wog, Wog, Wog, Wog, Wog, Wog, Wog, Wog, Wog, Wog, Wog, Wog, Wog, Wog, Wog, Wog, Wog, Wog, Wog, Wog, Wog, Wog, Wog, Wog, Wog, Wog, Wog, Wwg, Gs, Rp, Gs^Vhr, Gs, Gll^Fp, Gll^Fp, Gs, Gs, Gs, Gs
Wog, Wog, Wog, Wog, Wog, Wog, Wog, Wog, Wog, Wog, Wog, Wog, Wog, Wog, Wog, Ai, Wog, Wog, Wog, Wog, Wog, Wog, Wog, Ai, Wog, Wog, Wog, Ww^Vm, Wog, Wog, Wog, Wog, Wog, Wog, Wog, Wog, Wog, Wog, Ai, Wog, Ww^Vm, Wog, Wog, Wwg, Wwg, Rp, Gs, Gs, Gs, Gs, Gs, Gs, Gll^Fp, Gs
Wog, Wog, Wog, Wog, Wog, Wog, Wog, Wog, Wog, Wog, Wog, Wog, Ai, Wog, Wog, Wog, Wog, Wog, Wog, Wog, Wog, Wog, Wog, Wog, Wog, Wog, Wog, Wog, Wog, Wog, Wog, Wog, Wog, Wog, Wog, Wog, Wog, Wog, Wog, Wog, Wog, Wog, Wog, Wog, Wwg, Rp, Gs, Gs, Gs, Gs, Gs, Gll^Fp, Gs, Gs
Wog, Wog, Wog, Wog, Wog, Wog, Wog, Wog, Wog, Wog, Wog, Wog, Wog, Wog, Wog, Wog, Wog, Wog, Wog, Wog, Wog, Wog, Wog, Wog, Wog, Wog, Wog, Wog, Wog, Wog, Wog, Wog, Wog, Wog, Cme, Wog, Wog, Wog, Wog, Wog, Wog, Wog, Wog, Wog, Wwg, Rp, Gs, Gs, Hh, Gs, Gs, Gs, Gs, Gs
Wog, Wog, Wog, Wog, Wog, Wog, Wog, Wog, Wog, Wog, Wog, Wog, Wog, Wog, Wog, Wog, Wog, Wog, Wog, Wog, Wog, Wog, Wog, Wog, Wog, Wog, Ai, Wog, Wog, Wog, Wog, Wog, Ww^Vm, Cme, Kme, Cme, Wog, Wog, Wog, Wog, Wog, Wog, Wog, Wog, Wwg, Rp, Gs, Gs, Gs, Gs, Gs, Gs, Wwg, Wwg
Wog, Wog, Wog, Wog, Wog, Wog, Wog, Wog, Wog, Wog, Wog, Wog, Wog, Wog, Wog, Wog, Wog, Wog, Wog, Wog, Wog, Wog, Wog, Wog, Wog, Wog, Wog, Wog, Wog, Wog, Wog, Wog, Wog, Cme, Cme, Cme, Wog, Wog, Wog, Wog, Wog, Wog, Wog, Wwg, Gs, Rp, Rp, Gs, Gs, Gs, Wwg, Wwg, Wog, Wog
Wog, Wog, Wog, Wog, Wwg, Wwg, Wwg, Wog, Wwg, Wwg, Wwg, Wog, Wwg, Wwg, Wwg, Wog, Wwg, Wog, Ai, Wwg, Wwg, Wwg, Wwg, Wog, Wwg, Wog, Wog, Wog, Wog, Wog, Wog, Wog, Wog, Wog, Wog, Wog, Wog, Wog, Wog, Wog, Wog, Wog, Wog, Wwg, Wwg, Gs, Aa, Rp, Wwg^Bsb\, Wwg, Wog, Wog, Wwg, Wwg
Wog, Wog, Wwg, Wwg, Gs, Gs, Gs, Wwg, Gs, Gs, Gs, Wwg, Gs, Gs, Gs, Wwg, Gs, Ai, Gs, Gs, Gs, Gs, Gs, Wwg, Gs, Wwg, Wwg, Wog, Wog, Wog, Wog, Wog, Wog, Wog, Wog, Wog, Wog, Wog, Ai, Wog, Wog, Wog, Wog, Wog, Wwg, Gs, Wwg, Wwg, Wog, Wog^Bsb\, Wwg^Bsb\, Wwg, Ch, Gs
Wog, Wog, Wwg, Gs, Gs, Gs, Gs, Gs, Gll^Fp, Gs, Gll^Fp, Gs, Gll^Fp, Gll^Fp, Gll^Fp, Gll^Fp, Gll^Fp, Gs, Gs, Gll^Fp, Gll^Fp, Gs, Gll^Fp, Gs, Gs, Gs, Gll^Fp, Wwg, Wwg, Wwg, Wwg, Wog, Wog, Wog, Wog, Wog, Wog, Wog, Wog, Wog, Wog, Wog, Wog, Wog, Wog, Wwg, Wog, Wog, Wog, Wwg, Ch, Rr, Gs, Gs
Wwg, Wwg, Gs, Gs, Gs, Gs, Gs, Gs, Gs, Gll^Fp, Gs, Gs, Gs, Gs, Gs, Gs, Gs, Gs, Gs, Gs, Gs, Gll^Fp, Gs, Gll^Fp, Gs, Gll^Fp, Gs, Gs, Gs, Gs, Gs, Wwg, Wwg, Wog, Wog, Wog, Wog, Wog, Wog, Wog, Wog, Wog, Wog, Wog, Wog, Wog, Wog, Wog, Wog, Wwg, Ww, Rr, Rr, Gs
