Gs, Gs, Gs, Gs, Gs, Gs, Gs, Gs, Gs, Gs, Gs, Gs, Gs, Gs, Gs, Gs, Gs, Wwg, Wwg, Gs, Gs, Gs, Gs, Gs, Gs, Gs, Gs, Gs, Gs, Gs, Gs, Gs, Gll^Fp, Gs, Gs, Gs
Gs, Gs, Gs, Gs, Ce, Gs, Gs, Aa^Fma, Aa^Fma, Gs, Gs, Gs, Gs, Gs, Gs, Gs, Gs, Gs, Wwg, Gs, Gs, Gs, Gll^Fp, Gs, Gs, Gs, Gs, Gs, Gs, Gll^Fp, Gs, Gs, Gs, Gs, Aa^Fma, Gs
Gs, Gs, Re^Vct, Ce, Ke, Ce, Gs, Aa^Fma, Gs, Gs, Gll^Fp, Gll^Fp, Gs, Gs, Gs, Gs, Gll^Fp, Gs, Wwg, Gs, Gs, Gs, Gll^Fp, Gs, Gs, Gs, Gs, Gs, Gs, Gll^Fp, Gs, Gs, Gs, Aa^Fma, Gs, Gs
Gs, Gs, Gs, Ce, Ce, Ce, Gs, Gs, Gs, Gs, Gs, Gll^Fp, Gs, Gs, Gs, Gs, Gs, Gs, Gd^Vhr, Wwg, Gs, Gs, Gs, Gs, Gs, Gs, Gll^Fp, Gs, Gs, Gs, Gs, Gs, Gs, Gs, Gs, Gs
Gs, Gs, Aa, Gs, Gs, Gs, Gs, Gs, Gs, Gs, Gs, Gs, Gs, Gs, Gs, Gll^Fp, Gs, Gs, Gs, Wwg, Gs, Gs, Gs, Aa, Gs, Gll^Fp, Gs, Gs, Gs, Gll^Fp, Gs, Gs, Gs, Gs, Gs, Gs
Gs, Gs, Aa, Gs, Gs, Gs, Gs, Gs, Gs, Gll^Fp, Gs, Gs, Gs, Gs, Gs, Gs, Gll^Fp, Gs, Gs, Wwg, Gs, Gs, Gs, Gs, Gs, Gs, Gll^Fp, Gs, Gs, Gs, Gs, Gs, Gs, Gs, Gs, Gs
Gs, Gs, Gs, Gs, Gs, Gs, Gs, Gs, Gs, Gll^Fp, Gs, Gs, Gs, Gs, Gs, Gs, Gs, Gs, Gs, Wwg, Aa, Aa, Gs, Gs, Gs, Gll^Fp, Gs, Gs, Gs, Gs, Gs, Gs, Gs, Gs, Gs, Gs
Rr, Rr, Rr, Gs, Gd^Vhr, Gs, Rr, Gs, Gs, Gs, Gs, Gs, Gs, Gs, Gs, Gs, Gs, Gs, Gs, Wwg, Gs, Gs, Gs, Gs, Gs, Gs, Gs, Gs, Gs, Gs, Gs, Gll^Fp, Gll^Fp, Gs, Gs, Gs
Gs, Gs, Gs, Rr, Rr, Rr, Gll^Fp, Rr, Rr, Rr, Aa, Aa, Gs, Gll^Fp, Gs, Gs, Gs, Gs, Wwg, Wwg, Ce, Gs, Gs, Gs, Gs, Gs, Gll^Fp, Gs, Gs, Gs, Aa, Gs, Gs, Gs, Gs, Gs
Gs, Gs, Gs, Gll^Fp, Gll^Fp, Gs, Gs, Gs, Gs, Gs, Gs, Rr, Rr, Gll^Fp, Rr, Gs, Gs, Wwg, Ce, Ce, Ce, Ce, Gs, Gs, Gll^Fp, Gll^Fp, Gs, Gs, Gs, Aa, Gs, Gll^Fp, Gll^Fp, Gs, Gs, Gs
Gs, Gs, Gs, Gs, Gs, Gs, Gs, Gll^Fp, Gll^Fp, Gs, Gs, Gs, Gs, Rr, Gs, Rr, Rr, Wwg, Ce, Ke, Ce, Ce, Gs, Gs, Gs, Gs, Gll^Fp, Gs, Gs, Gs, Gs, Gs, Gs, Gs, Gs, Gs
Gs, Gs, Gs, Gs, Gs, Gs, Gs, Gs, Gs, Gs, Gs, Gs, Gs, Gs, Gs, Gs, Gs, Wwg^Bw\, Rr, Ce, Re^Vct, Gs, Gs, Gs, Gs, Gs, Gs, Gs, Gs, Gs, Gs, Aa, Gs, Gs, Gs, Wwg
Gs, Gs, Aa, Aa, Gs, Gs, Aa, Aa, Aa, Gs, Gs, Gs, Gs, Gll^Fp, Gs, Gs, Gs, Wwg, Gs, Rr, Rr, Gs, Gs, Gs, Gs, Gs, Gd^Vhr, Gs, Gll^Fp, Gll^Fp, Gs, Gs, Gs, Gs, Gs, Wwg
Gs, Gs, Gs, Gs, Gs, Gs, Gs, Gs, Gs, Gs, Gs, Gs, Gs, Gs, Gs, Aa^Fma, Gs, Wwg, Gs, Gs, Gs, Rr, Rr, Gs, Gs, Gs, Gs, Gs, Gs, Gs, Gs, Gs, Gs, Gs, Wwg, Wwg
Wwg, Wwg, Wwg, Wwg, Wwg, Wwg, Wwg, Gs, Gs, Gs, Gs, Gs, Gs, Gll^Fp, Gs, Aa^Fma, Gs, Wwg, Gs, Gs, Gs, Gll^Fp, Gll^Fp, Rr, Gs, Gs, Gs, Gs, Gll^Fp, Gs, Gs, Gs, Gs, Gs, Wwg, Wog
Wog, Wog, Wog, Wog, Wog, Wog, Wog, Wwg, Wwg, Gs, Wwg, Gs, Gs, Gs, Gs, Gs, Gs, Wwg, Gs, Gll^Fp, Gs, Gs, Gll^Fp, Rr, Rr, Gs, Gs, Gs, Gs, Gll^Fp, Gs, Gs, Gs, Gs, Wwg, Wog
Wog, Wog, Wog, Wog, Wog, Wog, Wog, Wog, Wog, Wwg, Wog, Wwg, Wwg, Gs, Wwg, Gs, Gs, Wwg, Wwg, Gs, Gs, Gll^Fp, Gs, Gs, Gs, Rr, Aa, Gs, Gs, Gs, Gs, Gs, Gs, Gs, Wwg, Wog
Wog, Wog, Wog, Wog, Wog, Wog, Wog, Wog, Wog, Wog, Wog, Wog, Wog, Wwg, Wog, Wwg, Wwg, Gs, Wwg, Gs, Wwg, Gs, Gs, Gs, Gs, Aa, Gs, Rr, Gs, Gs, Gs, Gs, Gs, Wwg, Wog, Wog
Wog, Wog, Wog, Wog, Wog, Wog, Ww^Vm, Wog, Wog, Wog, Wog, Wog, Wog, Wog, Wog, Wog, Wog, Wwg, Wog, Wwg, Wog, Wwg, Wwg, Gs, Gs, Gs, Gs, Rr, Rr, Gs, Gs, Gs, Gs, Wwg, Wog, Wog
Wog, Wog, Wog, Wog, Wog, Wog, Wog, Wog, Wog, Wog, Wog, Wog, Wog, Wog, Wog, Wog, Wog, Wwg, Cme, Wwg, Wog, Wog, Wog, Wwg, Wwg, Gs, Gs, Gs, Gs, Rr, Rr, Gs, Wwg, Wwg, Wog, Wog
Wog, Wog, Wog, Wog, Wog, Wog, Wog, Wog, Wog, Wog, Wog, Wog, Wog, Wog, Wog, Wog, Ww^Vm, Cme, Kme, Cme, Wog, Wog, Wog, Wog, Wog, Wwg, Wwg, Gs, Gs, Aa, Wwg, Wog^Bsb\, Wog^Bsb\, Wog, Wwg, Wwg
Wog, Wog, Wog, Wog, Wog, Wog, Wog, Wog, Wog, Wog, Wog, Wog, Wog, Wog, Wog, Wog, Wog, Cme, Cme, Cme, Wog, Wog, Wog, Wog, Wog, Wog, Wog, Wwg, Wwg, Wwg, Wog, Wog, Wwg, Wog^Bsb\, Rrc, Ch
Wog, Wog, Wog, Wog, Wog, Wog, Wog, Wog, Wog, Wog, Wog, Wog, Wog, Wog, Wog, Wog, Wog, Wog, Wog, Wog, Wog, Wog, Wog, Wog, Wog, Wog, Wog, Wog, Wog, Wog, Wwg, Wwg, Gs, Ch, Rrc, Gs
