Gll^Fp, Gll^Fp, Gll^Fp, Gll^Fp, Gll^Fp, Gll^Fp, Gll^Fp, Gll^Fp, Gll^Fp, Gll^Fp, Gll^Fp, Gll^Fp, Gll^Fp, Gll^Fp, Gll^Fp, Gll^Fp, Gll^Fp, Gll^Fp, Gs, Gs, Gll^Fp, Gll^Fp, Gll^Fp, Gll^Fp, Aa^Fpa, Gll^Fp, Gs, Gll^Fp, Gll^Fp, Gll^Fp, Gll^Fp, Gll^Fp, Gll^Fp, Gll^Fp, Gll^Fp, Gll^Fp, Gs, Gs, Gs, Gs, Gs, Gll^Fp, Gs, Gs, Gs, Gs
Gs, Gll^Fp, Gll^Fp, Gll^Fp, Gll^Fp, Gll^Fp, Aa, Gs, Cv, Gs, Aa, Aa, Gs, Gs, Gll^Fp, Gll^Fp, Gs, Gll^Fp, Gll^Fp, Gs, Gll^Fp, Gll^Fp, Gs, Gs, Gll^Fp, Aa^Fpa, Gs, Gs, Gs, Gll^Fp, Gs, Gll^Fp, Gs, Gll^Fp, Gll^Fp, Gll^Fp, Gs, Gs, Gs, Aa, Aa, Gll^Fp, Gs, Gs, Gs, Gs
Gs, Gs, Gll^Fp, Gs, Gll^Fp, Aa, Gll^Fp, Cv, Kva, Cva, Gs, Aa, Gs, Aa, Aa^Fpa, Gs, Gll^Fp, Aa^Fpa, Aa^Fpa, Aa, Aa, Gll^Fp, Gll^Fp, Gg^Ve, Gll^Fp, Gs, Gll^Fp, Gs, Gs, Gs, Gll^Fp, Gs, Gs, Gll^Fp, Gs, Gs, Gs, Gs, Gs, Aa, Gs, Aa, Gs, Gd^Vhr, Gs, Gs
Gs, Gs, Gs, Gll^Fp, Gs, Aa, Gg^Ve, Gg^Fet, Cv, Aa^Feta, Gs, Gll^Fp, Gll^Fp, Aa^Fpa, Aa^Fpa, Aa^Fpa, Gs, Gs, Aa^Fpa, Aa^Fpa, Gs, Gs, Gll^Fp, Gs, Gs, Gll^Fp, Gs, Gs, Aa^Fpa, Gll^Fp, Gll^Fp, Gll^Fp, Gs, Gs, Aa, Aa, Gll^Fp, Gs, Gs, Gll^Fp, Gs, Gs, Gs, Gll^Fp, Gs, Gs
Gs, Gll^Fp, Gll^Fp, Gll^Fp, Gs, Gll^Fp, Gs, Cv, Cv, Cv, Gs, Gll^Fp, Gll^Fp, Aa^Fpa, Gs, Gs, Gll^Fp, Gll^Fp, Gll^Fp, Gll^Fp, Gs, Gs, Gll^Fp, Gll^Fp, Gs, Gll^Fp, Gll^Fp, Aa^Fpa, Aa^Fpa, Gll^Fp, Gs, Gs, Gs, Gs, Gs, Gs, Gs, Gs, Gs, Gll^Fp, Aa^Fpa, Gs, Gs, Gs, Gs, Gs
Gll^Fp, Gs, Gll^Fp, Gs, Gll^Fp, Gll^Fp, Gs, Gs, Gll^Fp, Gs, Gll^Fp, Gs, Gll^Fp, Gs, Gs, Gs, Gs, Gs, Gll^Fp, Gs, Gll^Fp, Gs, Gll^Fp, Gs, Gll^Fp, Gll^Fp, Gll^Fp, Aa^Fpa, Gs, Gs, Gs, Gs, Gs, Gd^Vhr, Gs, Gs, Gll^Fp, Gs, Aa, Aa^Fpa, Aa^Fpa, Gs, Aa, Gs, Gs, Gs
Gll^Fp, Gll^Fp, Gs, Aa, Aa, Aa^Fpa, Gll^Fp, Gs, Gs, Gs, Gs, Gll^Fp, Gs, Gs, Gll^Fp, Gs, Aa, Aa, Gs, Gs, Gll^Fp, Gs, Gs, Gll^Fp, Gs, Gll^Fp, Aa, Gs, Aa, Gs, Gs, Gll^Fp, Gs, Gs, Gll^Fp, Gll^Fp, Gs, Gs, Gs, Aa, Gll^Fp, Gs, Aa, Aa, Aa, Gs
Gs, Gll^Fp, Gll^Fp, Gll^Fp, Aa, Aa^Fpa, Aa^Fpa, Gll^Fp, Gs, Gs, Gll^Fp, Gll^Fp, Gs, Gll^Fp, Gs, Aa, Aa, Aa, Gll^Fp, Gll^Fp, Gll^Fp, Gll^Fp, Gs, Gll^Fp, Gs, Gs, Aa, Aa, Aa, Aa, Gs, Gll^Fp, Gs, Gs, Gs, Gs, Gs, Gll^Fp, Gs, Gs, Gs, Gs, Gs, Aa, Gs, Gs
Gs, Gll^Fp, Gll^Fp, Gs, Gll^Fp, Aa, Gll^Fp, Gll^Fp, Gll^Fp, Gs, Aa, Aa, Aa, Gll^Fp, Gs, Gs, Gll^Fp, Gs, Gs, Gll^Fp, Gll^Fp, Gll^Fp, Ce, Gs, Re^Vct, Gs, Aa, Aa, Gs, Aa, Gs, Gs, Gll^Fp, Gll^Fp, Gs, Gs, Gs, Gll^Fp, Gll^Fp, Gll^Fp, Gs, Gs, Gll^Fp, Gs, Gs, Gs
Gs, Gll^Fp, Aa^Fpa, Gs, Gll^Fp, Gs, Gll^Fp, Gll^Fp, Gs, Gll^Fp, Gs, Aa, Aa, Aa, Gll^Fp, Gll^Fp, Gll^Fp, Gll^Fp, Gll^Fp, Gll^Fp, Gs, Ce, Ket, Ce, Ce, Gs, Gll^Fp, Gs, Gs, Gll^Fp, Gs, Gs, Gs, Gs, Gs, Gs, Gs, Gs, Gll^Fp, Gll^Fp, Gs, Gs, Gll^Fp, Gs, Gs, Gs
Gs, Gll^Fp, Aa^Fpa, Gs, Gll^Fp, Gll^Fp, Gs, Gs, Gll^Fp, Gs, Gll^Fp, Gll^Fp, Gs, Gll^Fp, Gll^Fp, Gll^Fp, Aa^Fpa, Aa^Fpa, Aa^Fpa, Gll^Fp, Gs, Ce, Ce, Ce, Gs, Gs, Gs, Gll^Fp, Gll^Fp, Gll^Fp, Gs, Gs, Gs, Gs, Gs, Gs, Gs, Aa^Fpa, Gll^Fp, Gs, Gs, Gs, Gll^Fp, Gs, Gs, Gs
Gs, Aa^Fpa, Gll^Fp, Gs, Gll^Fp, Gll^Fp, Gll^Fp, Gs, Gll^Fp, Gll^Fp, Gll^Fp, Gll^Fp, Gll^Fp, Gs, Gs, Gll^Fp, Gll^Fp, Aa^Fpa, Aa^Fpa, Gs, Gll^Fp, Gll^Fp, Gll^Fp, Gs, Aa, Aa, Gs, Gll^Fp, Gs, Gll^Fp, Gs, Gs, Gll^Fp, Gs, Gs, Gll^Fp, Aa^Fpa, Aa^Fpa, Gs, Gs, Gs, Aa^Fpa, Gll^Fp, Gs, Gs, Gs
Gs, Aa^Fpa, Gs, Gs, Gll^Fp, Gll^Fp, Gll^Fp, Gs, Gs, Gll^Fp, Gs, Gll^Fp, Gs, Gll^Fp, Gll^Fp, Gs, Gs, Gll^Fp, Gs, Gll^Fp, Gll^Fp, Gll^Fp, Gll^Fp, Gll^Fp, Aa, Aa, Aa, Gs, Gll^Fp, Gs, Gs, Gs, Gs, Gs, Gd^Vhr, Gs, Gs, Gs, Gs, Gs, Gs, Aa^Fpa, Gs, Gs, Gs, Gs
Gs, Gll^Fp, Gll^Fp, Gll^Fp, Gll^Fp, Gs, Gs, Gll^Fp, Gll^Fp, Gll^Fp, Gs, Gll^Fp, Gs, Gll^Fp, Gll^Fp, Gll^Fp, Gll^Fp, Gs, Gll^Fp, Gs, Gll^Fp, Gll^Fp, Gll^Fp, Gs, Gs, Gs, Aa, Gs, Gs, Gll^Fp, Gll^Fp, Gs, Gs, Gs, Gs, Gs, Gs, Gs, Gll^Fp, Gs, Gs, Gs, Gs, Gs, Gs, Gs
Gs, Gll^Fp, Gll^Fp, Gs, Gll^Fp, Gs, Gll^Fp, Gs, Aa^Fpa, Gll^Fp, Gll^Fp, Gs, Gs, Gll^Fp, Aa^Fpa, Aa^Fpa, Gll^Fp, Gll^Fp, Gs, Gs, Gs, Gs, Gs, Gll^Fp, Gs, Gs, Gs, Gll^Fp, Gll^Fp, Gs, Gll^Fp, Gs, Gs, Gs, Gll^Fp, Gs, Gs, Gll^Fp, Gs, Gs, Gs, Gs, Gs, Gs, Gs, Gs
Gll^Fp, Gll^Fp, Gs, Gll^Fp, Gll^Fp, Gs, Gll^Fp, Aa^Fpa, Aa^Fpa, Gll^Fp, Gs, Gs, Gll^Fp, Gs, Gs, Aa^Fpa, Gll^Fp, Gs, Aa, Aa, Gs, Gs, Gs, Gs, Gs, Gs, Gs, Gs, Gs, Gll^Fp, Gs, Gll^Fp, Gs, Gs, Gs, Gs, Gs, Gll^Fp, Gs, Gs, Gs, Gs, Gs, Gs, Gs, Gs
Gll^Fp, Gll^Fp, Gll^Fp, Gll^Fp, Gs, Gs, Gll^Fp, Gll^Fp, Gll^Fp, Gll^Fp, Gll^Fp, Gll^Fp, Gll^Fp, Gll^Fp, Gs, Gll^Fp, Gs, Gs, Aa, Aa, Aa, Gs, Gll^Fp, Gs, Gs, Gll^Fp, Gs, Gs, Gs, Gs, Gs, Gs, Gll^Fp, Gs, Gs, Gs, Gs, Gs, Gll^Fp, Gs, Gs, Ce, Ce, Re^Vct, Gs, Gs
Gs, Gs, Gll^Fp, Gll^Fp, Gs, Gs, Gs, Gll^Fp, Gll^Fp, Gs, Gs, Gll^Fp, Gll^Fp, Gs, Gs, Gs, Gs, Aa, Aa, Gll^Fp, Gs, Gs, Gll^Fp, Gll^Fp, Gs, Gs, Gll^Fp, Gs, Gll^Fp, Gs, Aa^Fpa, Gs, Aa^Fpa, Gs, Gll^Fp, Gs, Gll^Fp, Gs, Gs, Gll^Fp, Gs, Ce, Ke, Ce, Ce, Gs
Gll^Fp, Gll^Fp, Gll^Fp, Gll^Fp, Gll^Fp, Gs, Gll^Fp, Gll^Fp, Aa^Fpa, Gll^Fp, Gll^Fp, Gs, Gs, Gs, Gs, Gs, Gs, Gs, Gs, Gs, Gs, Gs, Aa^Fpa, Gs, Gs, Gs, Gs, Gs, Gs, Gll^Fp, Gll^Fp, Aa^Fpa, Aa^Fpa, Gs, Gs, Gs, Gs, Gs, Gs, Gs, Gs, Gs, Gs, Cea, Gs, Gs
Gll^Fp, Gll^Fp, Gs, Gs, Gs, Gll^Fp, Gs, Gll^Fp, Gll^Fp, Aa^Fpa, Gs, Gs, Gg^Ve, Gll^Fp, Gll^Fp, Gs, Gs, Gs, Gll^Fp, Gs, Gs, Gs, Gs, Aa^Fpa, Aa^Fpa, Gs, Aa^Fpa, Gll^Fp, Gs, Gs, Gs, Gs, Gs, Gll^Fp, Gll^Fp, Gs, Gs, Gs, Gll^Fp, Gs, Aa, Gs, Aa, Gs, Gs, Gs
Gll^Fp, Gg^Ve, Cv, Cv, Cv, Gll^Fp, Gll^Fp, Gs, Gll^Fp, Aa^Fpa, Gs, Gs, Gs, Aa^Fpa, Gll^Fp, Gll^Fp, Gll^Fp, Gs, Gll^Fp, Gs, Gs, Gs, Gs, Gll^Fp, Gs, Gs, Aa^Fpa, Aa^Fpa, Gll^Fp, Gs, Gs, Gs, Gs, Gs, Gs, Gs, Gd^Vhr, Gs, Gll^Fp, Gs, Gs, Aa, Aa, Gs, Gs, Gs
Gll^Fp, Kva, Cv, Cv, Cv, Gll^Fp, Gll^Fp, Gll^Fp, Gs, Gll^Fp, Gll^Fp, Gs, Gs, Aa^Fpa, Aa^Fpa, Gll^Fp, Gll^Fp, Gs, Gs, Aa, Aa, Aa, Gs, Gs, Gs, Gs, Gs, Gs, Gs, Gs, Gs, Gs, Aa, Aa, Aa, Gs, Gs, Gs, Gs, Gll^Fp, Gs, Gs, Gs, Gs, Gs, Gs
Gll^Fp, Aa^Fpa, Aa^Fpa, Cv, Gll^Fp, Gll^Fp, Gll^Fp, Gll^Fp, Gs, Gs, Gs, Gs, Gll^Fp, Gll^Fp, Gll^Fp, Gll^Fp, Gll^Fp, Gs, Gs, Aa, Aa, Aa, Gs, Gll^Fp, Gs, Gs, Gs, Gs, Gs, Gll^Fp, Gs, Aa, Aa, Aa, Gs, Gs, Gs, Gs, Gs, Gs, Gs, Gs, Gs, Gs, Gs, Gs
